NumPlanes,LargestPlaneCount,AveragePlaneCount,AverageNumVertsPerPlane,AverageTextureSize,memManagementUS,preprocessingUS,segmentationUS,quadtreeUS,PipelineUS
0,0,0,0,0,739,1890,1620,138,4387
0,0,0,0,0,556,1621,1620,143,3940
0,0,0,0,0,548,1617,1612,131,3908
0,0,0,0,0,645,1623,1611,134,4013
0,0,0,0,0,544,1618,1610,135,3907
0,0,0,0,0,570,1661,1629,136,3996
0,0,0,0,0,616,1617,1606,132,3971
0,0,0,0,0,555,1612,1619,137,3923
0,0,0,0,0,544,1618,1618,137,3917
0,0,0,0,0,586,1664,1651,173,4074
0,0,0,0,0,566,1731,1880,137,4314
0,0,0,0,0,544,1613,1875,141,4173
0,0,0,0,0,569,1748,1869,162,4348
0,0,0,0,0,542,1621,2112,134,4409
0,0,0,0,0,550,1613,1892,137,4192
0,0,0,0,0,574,1658,1827,162,4221
0,0,0,0,0,528,1620,1885,138,4171
0,0,0,0,0,551,1611,1846,136,4144
0,0,0,0,0,549,1637,1740,137,4063
0,0,0,0,0,562,1652,1753,155,4122
0,0,0,0,0,569,1638,1733,135,4075
0,0,0,0,0,548,1613,1757,140,4058
0,0,0,0,0,550,1633,1821,138,4142
0,0,0,0,0,549,1634,1764,134,4081
0,0,0,0,0,565,1659,1864,145,4233
0,0,0,0,0,548,1648,1743,141,4080
0,0,0,0,0,570,1639,1619,153,3981
0,0,0,0,0,547,1629,1758,151,4085
0,0,0,0,0,562,1633,1722,134,4051
0,0,0,0,0,551,1618,1891,138,4198
0,0,0,0,0,558,1652,1617,143,3970
0,0,0,0,0,775,1626,1610,139,4150
0,0,0,0,0,394,1772,1669,147,3982
0,0,0,0,0,611,1635,1632,136,4014
0,0,0,0,0,656,1619,1630,131,4036
0,0,0,0,0,545,1618,1609,133,3905
0,0,0,0,0,547,1618,1609,171,3945
0,0,0,0,0,641,1667,1619,135,4062
0,0,0,0,0,546,1615,1621,132,3914
0,0,0,0,0,570,1653,1617,135,3975
0,0,0,0,0,559,1622,1617,135,3933
0,0,0,0,0,553,1624,1632,139,3948
0,0,0,0,0,725,1632,1649,130,4136
0,0,0,0,0,554,1624,1674,147,3999
0,0,0,0,0,574,1663,1698,168,4103
0,0,0,0,0,562,1702,1692,137,4093
0,0,0,0,0,552,1647,1687,134,4020
0,0,0,0,0,619,1709,1845,1271,5444
0,0,0,0,0,457,1668,1763,170,4058
1,153,153,515,262144,545,1734,1797,1774,5850
1,9096,9096,2471,262144,1268,1664,1815,1509,6256
1,10906,10906,2892,262144,1308,1826,1862,2020,7016
1,12185,12185,3039,262144,1413,2010,1871,2024,7318
1,12185,12185,3144,262144,1423,1888,1922,1932,7165
1,14462,14462,3755,262144,2433,2007,1941,2204,8585
1,14720,14720,4079,262144,2467,1936,1988,2281,8672
1,14433,14433,3793,262144,1503,1885,2068,2107,7563
1,15974,15974,4912,262144,1394,1695,2024,1897,7010
1,17010,17010,4626,524288,1249,1654,1979,2727,7609
1,17657,17657,4916,524288,1728,1687,1908,2716,8039
1,18049,18049,12315,1048576,1720,1698,1964,5360,10742
1,18840,18840,6456,524288,2767,1989,1935,2944,9635
1,20487,20487,6916,524288,1883,1698,1931,3030,8542
1,20574,20574,6702,524288,3237,1772,2009,3079,10097
1,21792,21792,6845,524288,2886,1957,2014,3169,10026
1,17637,17637,15750,1048576,1907,1741,2002,5335,10985
1,20915,20915,8231,524288,5345,2004,1942,3181,12472
1,16847,16847,16035,1048576,1966,1826,1961,5492,11245
1,21999,21999,9021,524288,6205,1971,2034,3193,13403
1,25556,25556,10194,524288,2138,1741,2149,3190,9218
1,23241,23241,8880,524288,2667,2088,2027,3830,10612
1,26430,26430,9949,524288,2135,2069,2015,3231,9450
1,18188,18188,8274,1048576,3340,1952,2067,5214,12573
1,15532,15532,18844,1048576,3288,2012,2116,5666,13082
1,12115,12115,17197,1048576,2938,1989,2227,6149,13303
1,20997,20997,9799,1048576,2923,1925,2049,5127,12024
1,28446,28446,12214,1048576,2659,2016,2062,5121,11858
1,22790,22790,9877,1048576,2963,1991,2085,5021,12060
1,21572,21572,9648,1048576,2675,2089,2143,5549,12456
1,21695,21695,9907,1048576,2705,2062,2119,5269,12155
1,22499,22499,9697,1048576,2625,2041,2148,5434,12248
1,23772,23772,9219,524288,2666,1895,2176,3581,10318
1,23741,23741,10473,1048576,1756,1699,2184,5576,11215
1,22498,22498,11213,1048576,2590,1891,2153,5758,12392
1,23445,23445,10424,524288,2767,2000,2122,3757,10646
1,23208,23208,12503,524288,1732,1673,2043,3891,9339
1,26497,26497,11463,524288,1872,1690,2073,3439,9074
1,29742,29742,13098,524288,1867,1729,2058,3495,9149
1,14924,14924,16312,1048576,1915,1684,2097,6267,11963
1,26577,26577,3586,131072,2774,1978,2107,1704,8563
1,25405,25405,4018,131072,1168,1761,2113,1652,6694
1,26806,26806,4003,131072,1166,1659,2126,1515,6466
1,26784,26784,3967,131072,1182,1672,2135,1932,6921
1,26337,26337,3937,131072,1216,1720,2284,1660,6880
1,52613,52613,3794,262144,1343,1856,2311,3916,9426
1,60969,60969,3352,262144,1402,1708,2195,2586,7891
1,69676,69676,3725,262144,1433,1660,2203,2273,7569
1,76806,76806,3553,262144,1391,1718,2114,2186,7409
1,80072,80072,3614,262144,1484,1708,2200,2976,8368
1,82978,82978,3845,262144,2219,1990,2192,3224,9625
1,82294,82294,3653,262144,1485,1716,2204,2374,7779
1,81095,81095,3756,262144,1986,1763,2139,2246,8134
1,78074,78074,4012,262144,2306,2009,2164,2233,8712
1,73348,73348,4064,262144,2214,2040,2210,2265,8729
1,71917,71917,3826,262144,1415,1691,2192,2314,7612
1,70433,70433,3632,262144,1485,1701,2166,2194,7546
1,69213,69213,3806,262144,1411,1667,2160,2409,7647
1,68288,68288,3583,262144,2139,1731,2185,2998,9053
1,67040,67040,3435,262144,1454,1707,2149,2083,7393
1,65656,65656,3477,262144,1461,1674,2205,2397,7737
1,64202,64202,3348,262144,1503,1746,2224,2571,8044
1,63081,63081,3409,262144,1336,1683,2251,2156,7426
1,62070,62070,7740,524288,1885,1669,2202,3640,9396
1,61189,61189,7612,524288,1721,1681,2218,3800,9420
1,24924,24924,5578,1048576,1735,1700,2205,5022,10662
1,59535,59535,7675,524288,2810,1950,2265,3839,10864
1,59206,59206,7624,524288,1785,1694,2203,3726,9408
1,59295,59295,7577,524288,1733,1691,2146,3713,9283
1,58870,58870,7658,524288,2302,1811,2208,3791,10112
1,58686,58686,7420,1048576,2184,2589,2263,5248,12284
1,58342,58342,7697,524288,2897,6689,2280,4535,16401
1,57400,57400,7181,1048576,1677,1699,2839,6082,12297
1,31755,31755,5017,524288,5521,1931,2180,3403,13035
1,30861,30861,6337,1048576,1716,1706,2184,5540,11146
1,33616,33616,5553,524288,2630,1957,2173,3469,10229
1,32525,32525,6457,1048576,1721,1724,2178,5143,10766
1,35376,35376,5799,524288,3228,1927,2183,3744,11082
1,34371,34371,2938,262144,1714,1670,2194,2514,8092
1,35527,35527,2902,262144,1410,1713,2185,2147,7455
1,36716,36716,3025,262144,1418,1677,2184,2310,7589
1,37953,37953,3013,262144,1441,1715,2199,2329,7684
1,39478,39478,2983,262144,1443,1734,2243,2282,7702
1,36117,36117,6720,524288,1468,1704,2266,3404,8842
1,43038,43038,6870,1048576,2961,1962,2208,5845,12976
1,45373,45373,6922,524288,5046,2123,2230,3885,13284
1,47532,47532,7234,524288,2671,1834,2240,4076,10821
1,39685,39685,7031,524288,2415,2162,2387,4630,11594
1,49793,49793,8862,524288,1738,1692,2220,3940,9590
1,41768,41768,6970,524288,1747,1690,2255,3325,9017
1,52751,52751,8610,524288,1727,1679,2230,3660,9296
1,53384,53384,8719,524288,1776,1682,2213,3444,9115
1,57257,57257,7860,524288,1748,1682,2222,4031,9683
1,59063,59063,7936,524288,1717,1721,2238,3809,9485
1,61089,61089,7946,524288,1736,1686,2218,3907,9547
1,63447,63447,3568,262144,1729,1674,2248,2353,8004
1,66027,66027,3533,262144,1400,1658,2233,2574,7865
1,68562,68562,3641,262144,1413,1711,2244,2391,7759
1,70784,70784,3425,262144,1607,1698,2261,2493,8059
1,72901,72901,3498,262144,2582,1981,2261,2931,9755
1,74523,74523,3647,262144,2338,1939,2241,3467,9985
1,76072,76072,3721,262144,1461,1707,2224,2490,7882
1,77679,77679,3643,262144,1394,1755,2299,2993,8441
1,79006,79006,3539,262144,1711,1800,2269,2696,8476
1,80200,80200,3564,262144,1402,1678,2267,2518,7865
1,81083,81083,3648,262144,1429,1657,2238,2606,7930
1,81468,81468,3573,262144,2037,1719,2264,3208,9228
1,81681,81681,3649,262144,2375,1887,2270,2785,9317
1,81711,81711,3618,262144,1463,1724,2241,2925,8353
1,81573,81573,3452,262144,1494,1709,2220,2550,7973
1,81445,81445,3628,262144,1412,1662,2323,2696,8093
1,81319,81319,3763,262144,1715,1768,2284,2736,8503
1,80886,80886,3653,262144,1413,1663,2322,2726,8124
1,80326,80326,3660,262144,1825,1766,2388,2719,8698
1,79144,79144,3875,262144,1480,1854,2259,2619,8212
1,78348,78348,3960,262144,1415,1688,2297,2876,8276
1,77430,77430,4048,262144,1449,1683,2295,2677,8104
1,76697,76697,4151,262144,1608,1762,2304,2505,8179
1,75873,75873,4226,262144,1362,1726,2296,2482,7866
1,74753,74753,4183,524288,1304,1694,2300,3121,8419
1,73376,73376,4522,262144,1719,1686,2307,2335,8047
1,71237,71237,4230,262144,1271,1673,2284,2360,7588
1,68730,68730,4138,524288,1314,1700,2300,3287,8601
1,66282,66282,3989,524288,1726,1691,2353,3322,9092
1,64333,64333,4231,524288,1960,1736,2388,3369,9453
1,62611,62611,4433,524288,1749,1733,2345,3700,9527
1,84588,84588,4596,524288,2068,1705,2333,3123,9229
1,83977,83977,4642,524288,1735,1683,2349,3227,8994
1,83866,83866,4335,524288,1839,1713,2353,3181,9086
1,83219,83219,4745,524288,3154,1905,2313,3376,10748
1,54789,54789,4896,524288,1715,1672,2474,3364,9225
1,81687,81687,8953,1048576,1755,1741,2318,6181,11995
1,82311,82311,8645,1048576,5120,2039,2432,6033,15624
1,80523,80523,8137,1048576,4453,1973,2379,6947,15752
1,78973,78973,8208,1048576,5567,1894,2284,5411,15156
1,77347,77347,7565,1048576,2622,1958,2266,5460,12306
1,74819,74819,7534,1048576,2651,1995,2250,5576,12472
1,71920,71920,7246,1048576,2631,1994,2245,5469,12339
1,68174,68174,6874,1048576,2662,1935,2236,5832,12665
1,64449,64449,6979,1048576,3006,2001,2249,5960,13216
1,60739,60739,6768,1048576,2766,1940,2247,5234,12187
1,56506,56506,6716,1048576,2663,2009,2186,5261,12119
1,52502,52502,6231,524288,2651,1940,2210,3724,10525
1,42283,42283,4689,524288,1719,1678,2207,3391,8995
1,41758,41758,4743,524288,1867,1744,2208,3427,9246
1,89219,89219,8907,262144,1778,1680,2172,2417,8047
1,95857,95857,8619,262144,1289,1769,2174,2305,7537
1,101441,101441,9803,262144,1281,1718,2161,2883,8043
1,106976,106976,9926,262144,2379,2299,2182,2473,9333
1,111263,111263,10071,262144,1301,1664,2153,2586,7704
1,115059,115059,8989,262144,1241,1694,2146,2346,7427
1,117304,117304,8901,262144,1449,1679,2142,2249,7519
1,118978,118978,8911,262144,1272,1667,2140,2283,7362
1,117567,117567,8500,262144,1515,1718,2217,2508,7958
1,112096,112096,7498,262144,1262,1659,2133,2238,7292
1,104299,104299,6894,262144,1500,1662,2218,2139,7519
1,96133,96133,10530,524288,1268,1676,2201,4048,9193
1,87688,87688,8710,524288,1829,1733,2176,3816,9554
1,55934,55934,3818,262144,2703,2043,2213,2439,9398
1,67499,67499,3908,262144,2745,1963,2252,2896,9856
1,78674,78674,4259,262144,1898,1765,2260,2814,8737
1,88544,88544,4365,524288,1987,2000,2232,3704,9923
1,96785,96785,4401,524288,2421,1840,2582,4105,10948
1,104085,104085,4548,524288,3194,1871,2186,3486,10737
1,111062,111062,4463,524288,1834,1702,2198,3367,9101
1,117596,117596,4550,524288,1796,1762,2205,4689,10452
1,123697,123697,4539,524288,2509,1949,2271,3680,10409
1,126723,126723,6274,524288,1720,1700,2337,3325,9082
1,130341,130341,4940,524288,2060,1713,2267,3726,9766
1,132493,132493,4944,524288,3134,1859,2292,3228,10513
1,135367,135367,4896,524288,2364,2071,2259,3372,10066
1,137217,137217,5191,524288,2010,1789,2248,3506,9553
1,139571,139571,4913,524288,1712,1735,2301,4728,10476
1,141990,141990,4744,524288,2179,1988,2278,3340,9785
1,144380,144380,4609,524288,1901,1853,2210,3422,9386
1,146193,146193,4955,524288,1890,1841,2288,3564,9583
1,147797,147797,4604,524288,1733,1680,2334,3452,9199
1,150557,150557,4903,524288,2316,1770,2248,4260,10594
1,155141,155141,5026,524288,1748,1678,2345,3626,9397
1,161268,161268,4811,524288,3057,1979,2517,4283,11836
1,166508,166508,5370,524288,2751,2118,2292,3478,10639
1,173058,173058,5520,524288,2547,1979,2177,3258,9961
1,181008,181008,6126,524288,1783,1845,2342,3359,9329
1,189788,189788,6023,524288,2526,1924,2146,4540,11136
1,198517,198517,6785,1048576,1974,1731,2252,7075,13032
1,206093,206093,13986,1048576,4350,2087,2149,6719,15305
1,213893,213893,12206,1048576,3364,1885,2174,6411,13834
1,219406,219406,13069,1048576,3067,1952,2176,6570,13765
1,225347,225347,11297,1048576,2877,2021,2224,6388,13510
1,229367,229367,12157,1048576,2818,1984,2198,6524,13524
1,230964,230964,11135,1048576,2918,1928,2176,6242,13264
1,231742,231742,11662,1048576,2801,1962,2226,6128,13117
1,232398,232398,10362,1048576,2742,1951,2209,5885,12787
1,229008,229008,13136,1048576,2565,1913,2234,5982,12694
1,232615,232615,8373,1048576,2742,1932,2186,6124,12984
1,227250,227250,11166,1048576,2634,1948,2214,5468,12264
1,227727,227727,10137,1048576,3955,1972,2188,5896,14011
1,230045,230045,9038,524288,2835,1993,2242,4061,11131
1,230689,230689,9115,524288,1795,1702,2232,4278,10007
1,230836,230836,8914,524288,1945,1754,2166,3948,9813
1,229688,229688,8640,524288,1778,1891,2157,4093,9919
1,227056,227056,9812,524288,2055,1765,2162,3942,9924
1,230019,230019,8649,524288,3520,1870,2144,4018,11552
1,229618,229618,8830,524288,3141,1900,2108,3788,10937
1,229932,229932,9049,524288,1922,1902,2139,3974,9937
1,229892,229892,8867,524288,2499,1982,2180,3606,10267
1,230174,230174,9173,524288,1735,1694,2245,3738,9412
1,229943,229943,8520,1048576,1972,1714,2155,6228,12069
1,229945,229945,8242,524288,2803,1997,2243,4725,11768
1,230356,230356,8458,524288,2354,2122,2410,3763,10649
1,230379,230379,8872,524288,1836,1771,2181,4121,9909
1,230345,230345,8885,524288,1714,1787,2221,3918,9640
1,230363,230363,8453,524288,1744,1724,2140,3705,9313
1,229904,229904,8797,524288,1727,1674,2152,3630,9183
1,229937,229937,8416,524288,1736,1690,2177,3705,9308
1,229822,229822,8135,524288,1736,1682,2153,3578,9149
1,229907,229907,7695,524288,1724,1667,2190,3591,9172
1,230650,230650,7961,524288,1778,1687,2184,3559,9208
1,231766,231766,7770,524288,1666,1878,2202,4369,10115
1,233372,233372,7600,524288,1967,1756,2137,3899,9759
1,235128,235128,7315,524288,2054,1763,2144,3547,9508
1,236745,236745,7416,524288,3087,1964,2199,4324,11574
1,239119,239119,6966,524288,2761,1968,2197,4136,11062
1,240854,240854,7212,524288,1918,1734,2185,3796,9633
1,241626,241626,6960,524288,3112,1907,2192,3750,10961
1,241249,241249,6977,524288,1832,1698,2242,6041,11813
1,240503,240503,7062,524288,1655,1702,2168,4239,9764
1,239364,239364,6756,524288,1721,1670,2160,3525,9076
1,238647,238647,7176,524288,1749,1681,2169,3637,9236
1,237581,237581,6743,524288,1846,1715,2174,3586,9321
1,234996,234996,6860,524288,1766,1685,2212,3587,9250
1,231281,231281,7081,524288,1787,1682,2174,3574,9217
1,228143,228143,6848,524288,1869,1800,2176,3751,9596
1,225105,225105,7291,524288,1729,1681,2147,3746,9303
1,220901,220901,7308,524288,1743,1661,2181,3593,9178
1,214359,214359,7350,524288,1775,1691,2231,3659,9356
1,204991,204991,6910,524288,1717,1676,2165,3733,9291
1,195078,195078,7068,524288,1746,1685,2186,3692,9309
1,183641,183641,6543,524288,1738,1677,2210,3537,9162
1,170707,170707,6480,524288,1776,1719,2194,3624,9313
1,156799,156799,6256,524288,1760,1721,2181,3416,9078
1,143879,143879,5353,524288,1875,1699,2372,3645,9591
1,132667,132667,5225,524288,1639,1786,2184,3914,9523
1,120898,120898,5221,524288,1752,1698,2193,3369,9012
1,106792,106792,4890,524288,1747,1696,2168,3257,8868
1,93976,93976,4866,524288,1725,1745,2170,3246,8886
1,82019,82019,8592,1048576,1762,1676,2175,5700,11313
1,57185,57185,4740,524288,2650,1929,2192,3431,10202
1,61291,61291,7313,524288,1853,1749,2223,3758,9583
1,51195,51195,6608,524288,1868,1801,2169,3946,9784
1,58716,58716,4674,524288,1728,1672,2167,3261,8828
1,59831,59831,4710,524288,1778,1679,2139,3201,8797
1,60505,60505,4809,524288,1790,1771,2166,3208,8935
1,84234,84234,9146,262144,1750,1687,2146,2183,7766
1,89158,89158,11737,524288,1262,1661,2153,3195,8271
1,91482,91482,14210,524288,1879,1710,2106,3139,8834
1,93392,93392,15703,524288,2047,2023,2380,3915,10365
1,97274,97274,16954,524288,2106,1772,2162,3413,9453
1,105327,105327,17335,524288,1718,1760,2125,3188,8791
1,115873,115873,17854,524288,1742,1693,2115,3341,8891
1,126512,126512,16528,524288,1780,1692,2144,3482,9098
1,137503,137503,14656,524288,1724,1683,2014,3472,8893
1,144523,144523,13215,524288,2042,1734,2045,3676,9497
1,141306,141306,15981,524288,1879,1680,2155,3682,9396
1,144714,144714,17531,524288,2242,1985,2015,3711,9953
1,139882,139882,19796,524288,1941,1748,2068,3737,9494
1,132776,132776,20358,1048576,3032,1933,1981,5333,12279
1,106977,106977,8228,524288,2653,2129,2131,3595,10508
1,121992,121992,8998,524288,2109,2027,2153,3429,9718
1,135224,135224,19753,1048576,1833,1700,2074,5937,11544
1,149249,149249,19022,1048576,2985,1789,2135,6009,12918
1,161899,161899,17076,1048576,5084,1989,2163,8516,17752
1,171707,171707,17186,1048576,3807,1957,2240,6990,14994
1,176630,176630,17511,1048576,2993,2032,2217,8652,15894
1,176608,176608,14762,1048576,3650,2002,2061,6452,14165
1,174499,174499,13188,1048576,3631,1899,2149,5406,13085
1,171512,171512,12085,524288,2765,2013,2123,3806,10707
1,169403,169403,12572,524288,1905,1693,2147,3798,9543
1,168241,168241,10858,524288,2011,1711,2111,3850,9683
1,166787,166787,10353,524288,2200,2031,2235,3637,10103
1,165340,165340,8741,524288,2005,1733,2216,3758,9712
1,157508,157508,3516,524288,3151,1938,2075,3380,10544
1,148509,148509,7431,524288,3244,1814,2135,3718,10911
1,139139,139139,7749,524288,1891,1671,1980,3157,8699
1,129626,129626,7012,524288,1797,1708,2080,3264,8849
1,120901,120901,6773,524288,1948,2492,2072,4568,11080
0,0,0,0,0,3216,1944,1889,134,7183
0,0,0,0,0,517,1655,1890,138,4200
0,0,0,0,0,608,1695,2003,194,4500
0,0,0,0,0,560,1627,1932,374,4493
0,0,0,0,0,572,1636,1767,142,4117
0,0,0,0,0,550,1631,1807,132,4120
0,0,0,0,0,542,1632,1831,136,4141
0,0,0,0,0,553,1634,1831,135,4153
0,0,0,0,0,554,1645,1847,133,4179
0,0,0,0,0,554,1641,1808,134,4137
0,0,0,0,0,551,1648,1800,136,4135
0,0,0,0,0,555,1636,1829,134,4154
0,0,0,0,0,553,1641,1908,162,4264
0,0,0,0,0,581,1652,1831,148,4212
0,0,0,0,0,597,1650,1837,131,4215
0,0,0,0,0,634,1689,1846,158,4327
1,21732,21732,19999,524288,555,1640,1796,3242,7233
1,2685,2685,6934,1048576,2078,2021,1877,4645,10621
0,0,0,0,0,2605,1986,1805,140,6536
0,0,0,0,0,557,1650,1820,146,4173
0,0,0,0,0,558,1664,1840,134,4196
0,0,0,0,0,571,1658,1871,133,4233
0,0,0,0,0,572,1650,1854,145,4221
1,27103,27103,12414,1048576,601,1729,2803,5276,10409
1,32663,32663,14413,1048576,6076,1963,2062,5794,15895
1,48450,48450,18721,1048576,5906,1956,1990,5027,14879
1,52750,52750,20855,1048576,2662,1926,1993,5501,12082
1,45614,45614,21349,1048576,2814,2112,1982,5801,12709
1,55809,55809,19463,1048576,2876,2245,2044,4997,12162
1,55219,55219,20408,1048576,2956,2069,2243,5671,12939
1,44617,44617,21727,1048576,6478,1875,2099,5676,16128
1,42769,42769,19978,1048576,2670,2006,2149,7244,14069
1,52051,52051,19304,1048576,3012,2036,2158,5369,12575
1,54530,54530,19534,1048576,6147,1979,2139,6393,16658
1,35004,35004,17224,1048576,2640,1970,2268,5798,12676
1,35232,35232,15537,1048576,3690,2306,2249,5544,13789
1,46366,46366,17859,1048576,3301,2115,2196,5692,13304
1,18447,18447,4998,524288,3060,1920,2239,3438,10657
1,28201,28201,15475,1048576,1786,1738,2497,5641,11662
1,39856,39856,5654,262144,3215,2132,2200,2419,9966
1,47684,47684,5552,262144,1298,1694,2180,1864,7036
1,52287,52287,5263,262144,1647,1866,2291,2234,8038
1,56400,56400,5853,524288,1261,1657,2294,2878,8090
1,60700,60700,6472,524288,1745,1684,2137,2904,8470
1,63916,63916,6177,524288,1813,1683,2121,2845,8462
1,65274,65274,7342,524288,1666,1862,2079,2859,8466
1,68222,68222,7193,524288,1879,1753,2150,2993,8775
1,69976,69976,7264,524288,1764,1750,2139,2986,8639
1,71521,71521,7103,524288,2535,1765,2162,3123,9585
1,73541,73541,7428,524288,2126,1731,2117,3047,9021
1,74876,74876,7707,524288,1734,1683,2116,3211,8744
1,76963,76963,8003,524288,1795,1704,2145,3023,8667
1,79367,79367,8488,524288,1729,1680,2184,3071,8664
1,82387,82387,8752,524288,1848,1692,2217,3314,9071
1,83450,83450,8963,524288,1769,1688,2218,3198,8873
1,81489,81489,8685,524288,1748,1696,2166,3239,8849
1,79650,79650,8571,524288,1791,1681,2144,3264,8880
1,77397,77397,8678,524288,1971,1691,2112,3161,8935
1,78782,78782,8512,524288,1751,1686,2166,3133,8736
1,81297,81297,8190,524288,1734,1682,2157,3119,8692
1,87536,87536,7182,524288,1757,1696,2153,3038,8644
1,94661,94661,7015,524288,2838,1718,2177,3455,10188
1,102783,102783,6761,524288,2398,1803,2231,3207,9639
1,106950,106950,15715,1048576,3039,1722,2141,6314,13216
1,110697,110697,17587,1048576,3585,1888,2375,5899,13747
1,115430,115430,18894,1048576,3938,2005,2132,5912,13987
1,122510,122510,18429,1048576,4479,1935,2130,6043,14587
1,131514,131514,18404,1048576,5493,1916,2112,5765,15286
1,140003,140003,18339,1048576,2945,1882,2131,5936,12894
1,147031,147031,17643,1048576,3029,1714,2140,5699,12582
1,154702,154702,18841,1048576,2736,1902,2135,5854,12627
1,165771,165771,18873,1048576,2905,1813,2464,5723,12905
1,177329,177329,17866,1048576,2862,1805,2166,6218,13051
1,189170,189170,16748,1048576,2682,1751,2176,5886,12495
1,198682,198682,17236,1048576,3506,1714,2209,6769,14198
1,205854,205854,16648,1048576,2794,1843,2237,5954,12828
1,211501,211501,16332,1048576,2849,2095,2470,5945,13359
1,216852,216852,15778,1048576,3122,1991,2166,5846,13125
1,221070,221070,13831,1048576,3462,1912,2200,6083,13657
1,221518,221518,13675,1048576,5759,2083,2225,6957,17024
1,220191,220191,13676,1048576,2869,1958,2135,6175,13137
1,218488,218488,12974,1048576,3606,2042,2246,5948,13842
1,215201,215201,13290,1048576,3197,2097,2159,6332,13785
1,211974,211974,14074,1048576,4918,2050,2235,6091,15294
1,208237,208237,14383,1048576,3110,1944,2162,6569,13785
1,201638,201638,14609,1048576,3284,1927,2172,6242,13625
1,195066,195066,14641,1048576,2766,2061,2132,6458,13417
1,190310,190310,14097,1048576,4242,1854,2327,6235,14658
1,184941,184941,13854,1048576,3082,2149,2234,6079,13544
1,180931,180931,13314,1048576,3211,2136,2400,5727,13474
1,177328,177328,12830,1048576,3016,1798,2174,5896,12884
1,173844,173844,13333,1048576,2774,1975,2141,5664,12554
1,169478,169478,12899,1048576,2820,1976,2136,5757,12689
1,164313,164313,13558,1048576,3127,2003,2202,5948,13280
1,161081,161081,13393,1048576,3039,1996,2242,6305,13582
1,154715,154715,13724,1048576,2866,1970,2312,6490,13638
1,149180,149180,12723,1048576,3046,1920,2210,5600,12776
1,138788,138788,11208,1048576,2794,1978,2150,5538,12460
1,124470,124470,9964,524288,2979,1910,2209,3769,10867
1,116391,116391,9996,524288,1963,1783,2204,3665,9615
1,105946,105946,9667,524288,1713,1684,2075,3460,8932
1,72230,72230,8661,524288,1810,1807,2075,3367,9059
0,0,0,0,0,1899,1737,2038,137,5811
1,75919,75919,3819,524288,567,1647,2154,3131,7499
1,36867,36867,15027,1048576,1902,1698,2122,5231,10953
1,56614,56614,5711,524288,2873,1781,2073,3396,10123
1,51845,51845,5129,1048576,1748,1670,2119,5185,10722
1,45177,45177,4345,262144,2689,1725,2072,2039,8525
1,45371,45371,4332,262144,1288,1765,2132,2201,7386
1,48286,48286,3657,262144,1518,1789,2228,2225,7760
1,47643,47643,3377,262144,1407,1665,2203,2309,7584
1,46853,46853,3855,262144,1423,1702,2210,2174,7509
1,27523,27523,4379,131072,1606,1738,2202,1599,7145
1,45873,45873,4195,262144,1073,1661,2180,1968,6882
1,45898,45898,3914,524288,1448,1665,2154,3288,8555
1,46356,46356,4217,524288,2005,1704,2142,3016,8867
1,48424,48424,4256,524288,1747,1683,2150,3044,8624
1,51100,51100,4290,524288,1702,1697,2219,3159,8777
1,54678,54678,4467,524288,1776,1775,2266,3412,9229
1,55521,55521,4625,524288,1802,1727,2160,3137,8826
1,57330,57330,4633,524288,1873,1760,2127,3245,9005
1,60124,60124,4774,524288,1752,1691,2198,3170,8811
1,64818,64818,4684,524288,1727,1694,2218,3198,8837
1,67863,67863,4895,524288,1948,1779,2206,3327,9260
1,71418,71418,4485,524288,1731,1681,2175,3378,8965
1,72150,72150,4680,524288,1963,1761,2189,3288,9201
1,67799,67799,4425,524288,1793,1718,2239,3243,8993
1,61749,61749,4167,524288,1830,1753,2189,3194,8966
1,55880,55880,3855,524288,1985,1688,2200,3151,9024
1,51621,51621,3796,262144,1893,1690,2156,2104,7843
1,46935,46935,3327,262144,1423,1677,2133,1878,7111
1,45750,45750,3415,262144,1560,1730,2156,2318,7764
1,48327,48327,4705,262144,1622,1660,2187,1948,7417
1,58151,58151,5051,262144,1284,1662,2176,2031,7153
1,66829,66829,5444,262144,1334,1680,2076,1982,7072
1,74193,74193,5312,262144,1278,1662,2152,2005,7097
1,82676,82676,5620,524288,1317,1690,2085,2999,8091
1,94666,94666,6715,524288,1790,1697,2093,3341,8921
1,107715,107715,7370,524288,1841,1774,2082,3460,9157
1,120100,120100,7228,524288,1868,1757,2205,3390,9220
1,134473,134473,7395,524288,1870,1827,2225,4168,10090
1,149596,149596,7234,524288,1765,1741,2217,3635,9358
1,164654,164654,7760,524288,1818,1771,2135,3572,9296
1,175564,175564,7919,524288,1725,1678,2131,3515,9049
1,186018,186018,8469,524288,1738,1697,2112,3559,9106
1,195193,195193,8350,1048576,1733,1677,2124,5100,10634
1,199235,199235,8254,1048576,3053,1916,2108,5257,12334
1,201420,201420,8663,1048576,2721,2031,2119,5173,12044
1,202316,202316,9450,1048576,2666,1969,2130,5450,12215
1,204324,204324,10138,1048576,3022,2028,2163,5355,12568
1,205031,205031,11135,1048576,3527,2095,2134,5675,13431
1,208213,208213,11593,1048576,2958,2129,2150,6075,13312
1,212636,212636,11351,1048576,3454,2111,2208,5709,13482
1,215734,215734,11333,1048576,3707,2100,2184,6329,14320
1,215764,215764,11569,1048576,3031,2020,2121,6587,13759
1,212672,212672,11688,1048576,2811,1901,2067,5931,12710
1,207562,207562,12738,1048576,3518,2153,2735,6338,14744
1,203856,203856,12010,1048576,3348,1873,2211,5373,12805
1,201015,201015,12382,1048576,3753,1997,2098,5830,13678
1,202220,202220,12174,1048576,4870,2004,2136,6202,15212
1,202791,202791,12962,1048576,5838,1983,2116,5701,15638
1,201556,201556,12848,1048576,3008,2151,2215,6066,13440
1,196927,196927,14884,1048576,3152,1915,2174,6300,13541
1,202584,202584,13734,1048576,2900,2103,2140,6120,13263
1,208762,208762,12866,1048576,3097,1952,2498,6158,13705
1,215966,215966,13440,1048576,3389,1855,2148,5864,13256
1,221036,221036,13971,1048576,3081,2747,2655,5592,14075
1,219589,219589,13665,1048576,3100,1899,2006,5834,12839
1,209145,209145,13812,1048576,3255,1709,1977,6676,13617
1,198213,198213,12998,524288,2885,1899,2082,4061,10927
1,188885,188885,13488,524288,1908,1805,2048,4134,9895
1,179486,179486,14017,524288,2211,1740,2037,5867,11855
1,180127,180127,14472,524288,1944,1774,2243,4294,10255
1,182087,182087,15822,1048576,1834,1745,1997,5670,11246
1,185062,185062,16829,1048576,4006,1952,1979,5411,13348
1,186495,186495,16807,1048576,2852,1939,2017,5649,12457
1,186134,186134,15686,1048576,5358,1892,2065,5633,14948
1,185576,185576,15073,1048576,6193,1941,2067,5968,16169
1,183532,183532,15065,1048576,5837,1972,2006,5668,15483
1,181840,181840,17260,1048576,3262,1851,2011,5444,12568
1,186201,186201,17156,1048576,2818,3951,2293,5619,14681
1,192062,192062,17972,1048576,2758,1825,2000,5475,12058
1,194028,194028,18375,1048576,2942,1736,2013,6621,13312
1,192710,192710,18134,1048576,3453,1813,2036,5495,12797
1,190878,190878,19054,1048576,3278,1935,2371,5741,13325
1,191653,191653,19416,1048576,2529,1728,2015,6314,12586
1,197289,197289,20849,1048576,4054,2040,2052,7226,15372
1,201124,201124,21419,1048576,5776,2096,2054,6093,16019
1,203023,203023,19938,1048576,2666,2595,2042,5860,13163
1,202383,202383,23866,1048576,5019,1936,2026,5810,14791
1,201351,201351,23155,1048576,5364,1965,2027,6076,15432
1,193161,193161,26555,1048576,2889,1854,2029,6260,13032
1,176462,176462,28948,1048576,3553,1816,1939,6217,13525
1,149209,149209,32619,1048576,3262,1875,1948,6206,13291
1,125277,125277,30260,1048576,3028,1790,1947,6370,13135
1,107129,107129,14294,524288,3122,1839,1927,3428,10316
1,100429,100429,12466,524288,2160,1989,1965,3371,9485
1,96776,96776,11481,524288,1803,1723,2045,3482,9053
1,95138,95138,13150,524288,1862,1802,2067,3535,9266
1,93894,93894,12694,524288,2313,1826,2069,3444,9652
1,90332,90332,12436,524288,2098,1798,2175,3402,9473
1,88632,88632,11726,524288,1733,1729,2077,3478,9017
1,86474,86474,10976,524288,2253,1878,2060,3341,9532
1,84072,84072,10709,524288,2315,1777,2068,3611,9771
1,81119,81119,11659,524288,1852,1740,2072,3286,8950
1,78138,78138,11224,524288,2197,1814,2061,3205,9277
1,75199,75199,11624,524288,1956,1728,2052,3157,8893
1,72639,72639,10936,524288,2144,1735,2120,3269,9268
1,69206,69206,11478,524288,1997,1712,2077,3355,9141
1,66586,66586,11229,524288,2059,1779,2049,3125,9012
1,64589,64589,11651,524288,2820,1805,2048,3164,9837
1,63290,63290,10910,524288,2677,1830,2048,3105,9660
1,61430,61430,10522,524288,1786,1719,2052,2988,8545
1,58543,58543,10208,524288,1806,1803,2112,3165,8886
1,54608,54608,10191,524288,2612,1854,2046,3153,9665
1,49997,49997,9745,524288,1932,1804,2057,3044,8837
1,45924,45924,9707,524288,2261,1844,2036,3002,9143
1,41764,41764,9555,524288,1938,1865,2081,3013,8897
1,37818,37818,8479,524288,1823,1728,2023,2994,8568
1,34570,34570,8484,524288,1678,1743,2015,3198,8634
1,31832,31832,8263,524288,1993,1786,2126,3020,8925
1,29732,29732,7684,524288,1774,1686,2084,3047,8591
1,27502,27502,7855,524288,1815,1745,2064,3004,8628
1,43042,43042,6834,1048576,1758,1824,2239,5072,10893
1,24458,24458,6246,524288,2766,1730,2096,3060,9652
1,22964,22964,6287,524288,1816,1814,2179,3003,8812
1,22280,22280,6085,524288,1701,1740,2083,2907,8431
1,48185,48185,7138,1048576,1804,1751,2072,5496,11123
1,49854,49854,7539,1048576,3043,2070,2157,5137,12407
1,52550,52550,7639,524288,2724,1969,2042,3479,10214
1,55227,55227,8153,524288,1803,1703,2035,3314,8855
1,57184,57184,8212,524288,1726,1739,2160,3551,9176
1,59162,59162,8649,524288,1740,1700,2193,3475,9108
1,61289,61289,8903,524288,2189,2041,2021,3390,9641
1,63606,63606,20262,1048576,1732,1753,2109,5627,11221
1,65440,65440,10453,524288,2711,2146,2083,3886,10826
1,68246,68246,22665,1048576,1754,1721,1963,5473,10911
1,70890,70890,11436,524288,2658,1949,1942,3617,10166
1,70497,70497,11688,1048576,1899,1731,2017,5095,10742
1,68518,68518,12343,524288,2979,2030,1920,3507,10436
1,67171,67171,12669,524288,1902,1971,2079,3100,9052
1,62352,62352,11897,1048576,2704,1942,1918,5248,11812
1,58149,58149,23674,524288,2914,2159,2036,3707,10816
1,51724,51724,21213,1048576,2826,1800,1965,5877,12468
1,46016,46016,18991,1048576,2716,1955,2231,5825,12727
1,38531,38531,4795,262144,2725,2004,2012,1921,8662
1,41970,41970,6991,524288,1286,1660,2058,3010,8014
1,45335,45335,6556,524288,1897,1711,2051,2915,8574
1,45588,45588,8383,524288,1914,1781,2053,3144,8892
1,49177,49177,6410,524288,1766,1771,2007,2922,8466
1,38523,38523,4980,1048576,1888,1789,2092,5422,11191
1,40360,40360,5327,1048576,2716,2017,2154,5327,12214
1,42503,42503,5278,1048576,2633,2135,2155,5482,12405
1,43980,43980,5293,524288,2686,2056,2202,3643,10587
1,44692,44692,2345,262144,1754,1682,2123,1978,7537
1,58446,58446,7657,1048576,1418,1817,2135,4901,10271
1,43905,43905,2680,262144,2620,1795,2278,2056,8749
1,42215,42215,8649,1048576,1276,1682,2204,5316,10478
1,39779,39779,8389,524288,2663,1778,2149,3473,10063
1,36149,36149,8828,524288,1867,1703,2137,3641,9348
1,32164,32164,8494,524288,1740,1707,2219,3365,9031
1,66533,66533,4585,262144,1775,1734,2290,2350,8149
1,23590,23590,6423,262144,1266,1661,2177,2187,7291
1,64038,64038,5281,262144,1836,1759,2346,2447,8388
1,62588,62588,5687,262144,1409,1914,3357,2536,9216
1,85168,85168,17354,524288,1339,1747,2096,3372,8554
1,90005,90005,17776,524288,1873,1772,2119,4697,10461
1,87922,87922,19781,524288,1751,1703,2307,3595,9356
1,92051,92051,18445,524288,1963,1984,2122,3618,9687
1,93374,93374,13476,524288,1731,1675,2217,3657,9280
1,91085,91085,9510,524288,2278,1975,2200,3430,9883
1,89409,89409,9424,524288,1857,1887,2123,3542,9409
1,85806,85806,11029,524288,1717,1690,2127,3436,8970
1,78609,78609,15537,524288,1893,1693,2087,3382,9055
1,43644,43644,5801,524288,1949,1745,2211,3739,9644
1,44423,44423,5786,524288,1861,1967,2147,3616,9591
1,45456,45456,5837,524288,1743,1677,2115,3497,9032
1,46306,46306,5834,1048576,2067,1713,2132,5201,11113
1,47441,47441,6150,1048576,2612,1733,2118,4971,11434
1,48672,48672,6070,1048576,2721,1741,2158,5117,11737
1,49826,49826,6067,1048576,2760,1721,2114,5376,11971
1,50732,50732,6129,1048576,2883,1848,2179,5204,12114
1,54164,54164,5107,524288,2684,1719,2229,3342,9974
1,56028,56028,5254,524288,1719,1699,2148,3318,8884
1,53627,53627,6212,1048576,1739,1678,2124,4953,10494
1,53714,53714,6116,1048576,2841,1822,2160,5165,11988
1,53694,53694,6018,524288,2745,2085,2143,3678,10651
1,53796,53796,6009,524288,1725,1695,2168,3639,9227
1,54131,54131,5827,524288,1712,1671,2144,3677,9204
1,54469,54469,5786,524288,1882,1701,2166,3762,9511
1,55029,55029,5597,524288,1727,1682,2144,3443,8996
1,56050,56050,5687,524288,1735,1682,2112,3576,9105
1,56828,56828,5616,524288,1741,1673,2133,3410,8957
1,57931,57931,5547,524288,1725,1672,2124,3350,8871
1,39340,39340,3918,262144,1785,1681,2121,2231,7818
1,78254,78254,9344,524288,1420,1680,2106,3669,8875
1,82354,82354,10199,524288,1744,1679,2096,3361,8880
1,86588,86588,10318,524288,1645,3674,2464,4338,12121
1,90560,90560,11403,524288,1738,1683,2250,3568,9239
1,64687,64687,5002,262144,1869,1755,2137,2360,8121
1,95581,95581,11398,524288,1316,1732,2199,3568,8815
1,98184,98184,10670,524288,1855,1709,2095,3329,8988
1,45230,45230,3839,262144,1731,1682,2108,2230,7751
1,45303,45303,3894,262144,1415,1664,2179,2561,7819
1,45319,45319,3725,262144,1391,1678,2119,2264,7452
1,106187,106187,9983,524288,1424,1670,2104,3317,8515
1,69802,69802,4499,262144,1725,1666,2114,2549,8054
1,46528,46528,3433,262144,1265,1650,2154,2361,7430
1,115951,115951,10395,524288,2486,2070,2157,3471,10184
1,119274,119274,10074,524288,3314,1989,2137,3581,11021
1,121395,121395,11448,524288,1813,1718,2200,5056,10787
1,124496,124496,11473,524288,2333,1945,2141,3498,9917
1,126497,126497,10841,524288,2887,2021,2174,3642,10724
1,127636,127636,11603,524288,1894,2486,2241,6567,13188
1,128310,128310,10363,524288,2192,2042,2128,3667,10029
1,129144,129144,8839,524288,2907,1932,2110,3448,10397
1,128306,128306,9611,524288,3186,1914,2119,3701,10920
1,128244,128244,9962,524288,1784,1873,2119,3511,9287
1,128121,128121,10136,524288,1768,1744,2088,3491,9091
1,128342,128342,9873,524288,1734,1666,2112,4222,9734
1,128141,128141,10353,524288,1764,1690,2106,3603,9163
1,127736,127736,9804,524288,1769,1688,2106,4172,9735
1,127079,127079,9648,524288,1799,1709,2121,3539,9168
1,125946,125946,9586,524288,1734,1695,2099,3533,9061
1,125474,125474,9254,524288,1730,1690,2088,3438,8946
