NumPlanes,LargestPlaneCount,AveragePlaneCount,AverageNumVertsPerPlane,AverageTextureSize,memManagementUS,preprocessingUS,segmentationUS,quadtreeUS,PipelineUS
8,57478,25129,3897,147456,3837,2027,2131,9167,17162
8,57235,25118,3766,147456,4377,1944,2157,9540,18018
8,56573,25064,3807,147456,3581,1756,2103,8092,15532
8,54850,24834,4072,147456,3935,1985,2136,8553,16609
9,55017,22119,3758,247580,4418,2070,2175,15594,24257
8,55155,24888,4006,147456,9858,1989,2112,8565,22524
8,54080,24768,4093,147456,4023,2010,2231,8713,16977
8,54548,24805,3983,147456,3513,1984,2390,8988,16875
8,55460,24856,3951,147456,6101,1993,2151,8641,18886
8,55054,24789,4166,147456,4936,1990,2122,9009,18057
8,54191,24647,4281,147456,4360,2103,2138,9610,18211
8,54997,24672,4226,147456,4526,2056,2134,10337,19053
8,55447,24867,3952,147456,3509,1927,2325,9220,16981
8,55993,24937,3962,147456,6058,2149,2147,9193,19547
8,55487,24984,3889,147456,3444,1991,2198,9517,17150
8,55309,25077,3714,147456,6599,2031,2127,8910,19667
8,53772,24976,3976,147456,3415,1941,2416,8973,16745
8,55175,25152,3834,163840,5086,2197,2196,12354,21833
8,56656,25249,3665,147456,4375,1831,2146,9759,18111
10,57707,20367,3078,120422,3462,2042,2182,8929,16615
8,58378,25251,3711,147456,7037,1990,2156,9246,20429
9,58009,22399,3399,132892,4631,2131,2167,9756,18685
8,58584,25261,3695,147456,6374,2083,2153,9527,20137
8,58386,25320,3684,147456,4988,2098,2133,9190,18409
9,57853,22955,3766,138353,5642,1995,2228,10314,20179
8,58186,25353,3876,147456,4688,1971,2164,13255,22078
8,59235,25577,3695,180224,6727,2007,2180,11175,22089
6,59882,28482,4106,185685,6217,2073,2191,13422,23903
8,62891,26033,3737,163840,4238,1896,2167,9436,17737
8,64476,26199,3781,180224,4661,2024,2155,10242,19082
9,66066,23827,3894,174762,5109,2094,2304,11665,21172
8,69287,26630,3641,196608,5302,1958,2428,10154,19842
8,71914,26942,3697,196608,4943,1983,2273,12380,21579
8,73363,27079,3844,196608,7673,2039,2135,10154,22001
8,75466,27410,3739,229376,4207,1830,2120,10441,18598
8,76441,27567,3648,225280,5518,1951,2414,11570,21453
8,77718,27833,3612,192512,4848,1805,2171,10267,19091
8,78618,28108,3642,225280,6740,2186,2236,10628,21790
8,79015,28294,3547,192512,8743,2072,2263,10940,24018
2,58744,40229,4274,196608,4700,1960,2441,3632,12733
8,81296,28554,3348,189440,2049,1726,2167,10004,15946
8,82741,28462,3341,196608,8941,2100,2339,12080,25460
8,85090,28577,3361,196608,5224,2120,2391,11449,21184
8,86138,28561,3338,188416,4375,1799,2218,9668,18060
8,87877,28675,3239,176128,4970,1935,2226,10180,19311
7,89976,32897,3492,182564,4399,2039,2225,9254,17917
7,92151,33109,3547,184905,6442,2044,2250,9710,20446
6,93283,38542,4026,210261,6337,1858,2229,9253,19677
6,93826,38674,3976,221184,4589,2081,2353,8574,17597
5,95054,46354,4514,262144,4557,2124,2183,8901,17765
4,96582,56246,5243,360448,4559,1782,2171,8180,16692
4,97919,56571,5165,294912,7181,2062,2159,7690,19092
4,99255,56902,5164,294912,3816,2656,2436,7854,16762
4,100484,57253,5150,294912,4022,2002,2323,7677,16024
4,102377,58005,5251,294912,5839,2075,2215,9815,19944
5,102271,46956,4488,242483,4425,1928,2156,8137,16646
4,102192,58154,5463,294912,4763,1783,2188,7404,16138
4,101251,58396,5219,294912,3345,2054,2137,8250,15786
4,100667,58498,5475,294912,5715,2028,2143,7258,17144
3,99920,71171,5582,349525,5564,1945,2183,6527,16219
4,98279,58874,5207,294912,4804,2051,2235,9718,18808
3,97036,70227,5407,262144,5173,2077,2295,5911,15456
1,94519,94519,8543,262144,5440,2006,2206,2625,12277
3,93241,56923,4559,185685,2371,1762,2246,4673,11052
3,92080,68662,5530,262144,2782,2215,2227,6130,13354
3,89825,67915,5820,262144,3191,2087,2203,6333,13814
4,88899,58696,5662,229376,4196,2094,2225,7051,15566
4,87445,58664,5559,229376,3428,1806,2269,7483,14986
4,86304,58810,5631,229376,5854,2019,2231,8951,19055
4,85357,58547,5712,229376,2590,2154,2253,8536,15533
4,84033,58419,5814,229376,4887,2042,2194,8488,17611
4,83610,58526,5855,262144,2899,1913,2193,6912,13917
4,82288,58590,5581,262144,4686,2007,2184,8109,16986
4,81389,58496,5717,262144,3162,1993,2372,7283,14810
4,80050,58455,5853,262144,5195,1980,2246,7690,17111
4,79308,58406,5902,262144,4744,2099,2409,7333,16585
4,79504,58452,5742,262144,4591,1991,2218,7055,15855
4,79637,58306,5912,262144,5546,2003,2181,7205,16935
4,79817,58417,5657,262144,4114,2064,2181,7664,16023
4,80135,58432,5959,262144,3893,2005,2168,7548,15614
4,79944,58301,5867,262144,5418,2234,2307,7836,17795
4,79929,58246,6133,262144,4672,1979,2405,7178,16234
4,80049,58408,6043,262144,4600,1793,2193,7501,16087
4,80090,58220,5984,262144,4963,2085,2251,7283,16582
4,80259,58075,5975,262144,4302,2105,2274,12557,21238
4,80303,57849,6073,458752,3385,2179,2170,12060,19794
4,80471,57870,5970,262144,7574,1851,2171,7456,19052
4,80396,57634,5878,262144,3598,1993,2178,7160,14929
4,79870,57215,5815,262144,2950,2037,2348,6765,14100
4,78244,55999,5566,327680,2801,2143,2215,7815,14974
4,77682,55478,5343,327680,6608,2023,2201,8553,19385
6,76808,38651,4206,234837,6348,1861,2189,8695,19093
6,76653,38691,4389,240298,4725,1961,2281,10200,19167
6,76326,38607,4352,240298,5978,2174,2304,10040,20496
6,76095,38514,4392,240298,7956,2072,2223,9392,21643
6,76040,38394,4330,240298,3948,1914,2303,9034,17199
6,76088,38519,4253,240298,4237,2098,2219,9226,17780
6,76278,38573,4475,294912,4797,2117,2217,10877,20008
6,76204,38485,4502,327680,8842,1813,3686,14660,29001
6,76601,38565,4396,294912,11913,2063,2535,12672,29183
6,77056,38574,4377,273066,8732,1987,2186,10162,23067
6,77854,38597,4381,294912,5259,2025,2307,11080,20671
6,78262,38735,4340,294912,5684,2036,2209,10620,20549
6,78711,38713,4323,294912,8034,2050,2229,10661,22974
6,78466,38859,4267,294912,5290,1951,2243,10768,20252
6,78488,38727,4349,294912,7781,2226,2208,10589,22804
6,78576,38753,4243,425984,5274,1991,2214,14560,24039
6,78615,38772,4279,294912,6398,1974,2181,10409,20962
6,78879,38951,4213,294912,8550,2076,2216,10903,23745
6,79078,39013,4255,294912,4435,2056,2189,10288,18968
6,78981,38935,4325,294912,6707,1983,2184,10510,21384
6,78760,38996,4206,294912,4569,2037,2177,11258,20041
6,78432,38989,4282,294912,4613,1950,2312,9974,18849
6,78117,39075,4338,273066,7802,2174,2225,11699,23900
6,77866,39113,4132,273066,5178,1793,2198,14069,23238
6,77844,39190,4308,283989,5112,1863,2239,10345,19559
6,77829,39105,4257,283989,8968,2079,2206,11110,24363
6,77929,39086,4341,283989,4979,2070,3069,11546,21664
6,77798,39161,4211,283989,4403,1982,2294,9760,18439
6,77583,39291,4149,415061,7907,2128,2203,14648,26886
6,76360,39079,4275,240298,7279,1968,2243,9651,21141
6,75702,39100,4320,240298,6386,2067,2229,10027,20709
6,75241,39181,4206,240298,3914,2083,2178,10057,18232
6,74857,39172,4277,218453,5287,1952,2177,9449,18865
6,74359,39147,4156,305834,6999,2007,2394,15664,27064
6,74187,39302,4292,349525,6206,2056,2135,14297,24694
6,73424,39238,4233,436906,16349,2089,2293,15984,36715
6,73301,39248,4409,349525,11643,1977,2191,11890,27701
6,72878,39282,4304,349525,6135,1969,2134,13587,23825
6,72282,39263,4202,349525,6297,1935,2135,11450,21817
6,71723,39232,4306,349525,7238,2029,2161,11402,22830
6,70868,39173,4289,349525,5108,2223,2216,11364,20911
6,70367,39247,4310,371370,6328,2052,2481,15106,25967
6,69661,39144,4419,371370,10748,2010,2162,12700,27620
6,68422,39169,4411,371370,5773,2057,2180,12862,22872
6,67623,39010,4484,371370,6780,1964,2155,11615,22514
6,67250,39218,4376,371370,8882,2068,2148,12232,25330
6,66555,39092,4255,371370,11907,2059,2191,12009,28166
6,65859,39012,4401,360448,10254,2078,2233,18917,33482
6,64249,38957,4491,360448,7971,2086,2171,12338,24566
6,63234,38872,4468,360448,5189,1774,2150,11471,20584
6,62154,38804,4302,360448,7064,1910,2236,11796,23006
6,61208,38734,4299,273066,5846,1807,2258,11739,21650
6,62434,38689,4262,338602,7144,1842,2247,12812,24045
6,66272,38672,4130,273066,6011,1765,2201,11123,21100
6,67759,38414,4341,273066,5569,2115,2265,9813,19762
6,69330,38424,4210,273066,6197,1784,2179,10779,20939
6,70910,38327,4219,262144,5121,1783,2198,10387,19489
6,72554,38408,4090,283989,7465,1761,2180,10170,21576
6,73778,38447,4071,251221,5154,1837,2221,9307,18519
6,75383,38612,3968,240298,4919,1754,3642,9981,20296
6,78116,38709,3984,243029,4468,1746,2864,9810,18888
4,80346,54411,5398,327680,5541,1913,2292,10155,19901
4,82808,54862,5407,327680,6718,1867,2184,8894,19663
4,84952,55313,5322,327680,3433,1718,2296,7971,15418
4,86310,55667,5429,327680,6434,1813,2231,9241,19719
4,85724,55310,5396,393216,5165,1811,2328,10427,19731
4,83204,55168,5504,393216,4734,2394,2317,9358,18803
4,81004,55088,5701,327680,4758,2837,2224,8231,18050
4,78812,55151,5693,327680,4184,1772,2250,8450,16656
4,82334,54952,6011,458752,3615,1776,2279,10009,17679
4,87798,55380,4438,327680,5917,1759,2191,7684,17551
4,93875,55879,4380,327680,4315,1795,2227,8391,16728
4,99102,56216,4591,327680,4670,1837,2210,7713,16430
4,104596,56742,4361,294912,4391,1806,2825,7369,16391
4,109522,57106,4335,294912,4161,1748,2316,9148,17373
4,113931,57247,4118,294912,5368,1781,2185,11666,21000
4,122518,57421,5303,311296,4036,1763,2185,8057,16041
4,126860,57500,5358,311296,3742,1759,2155,9364,17020
4,130493,57589,5217,311296,4084,1801,2203,8494,16582
4,133511,57446,5210,311296,5040,1801,2184,8290,17315
4,136006,57168,5334,311296,4290,1833,2229,8486,16838
4,137821,56615,5324,311296,3592,1952,2263,7986,15793
4,138623,56077,5223,311296,7052,1819,2156,7602,18629
4,139535,55610,4748,311296,3383,1750,2176,7999,15308
5,140251,44325,4152,347340,3518,2042,2230,9674,17464
4,140775,53571,5233,425984,6922,1868,2174,9745,20709
4,140609,52144,5067,475136,4582,1814,2353,9965,18714
5,140201,42385,5342,419430,7629,1779,2182,11760,23350
4,141619,48969,5221,327680,9521,1998,2217,8172,21908
5,142594,41918,7583,393216,3539,1853,2435,11303,19130
5,142812,41438,7733,393216,6441,1898,2255,10595,21189
5,144170,41535,7622,393216,8831,1879,2215,11083,24008
5,145508,41288,7796,367001,8366,1807,2236,11159,23568
2,144636,76956,4606,327680,6063,1773,2164,4965,14965
6,143892,33136,7073,247125,4184,1808,2237,9259,17488
5,142919,39532,8628,301465,7258,1816,2200,10043,21317
7,141751,27868,10471,365129,5429,1878,2239,16591,26137
3,141154,60789,12902,436906,7391,1834,2163,9253,20641
4,140962,46381,10981,344064,5424,1820,2131,8982,18357
4,141472,46860,5685,278528,4613,1944,2194,7382,16133
5,143055,39123,4979,229376,3257,2218,2244,7425,15144
4,146814,47970,6737,278528,3308,1836,2293,9066,16503
3,152290,64272,7919,305834,3233,1832,2174,6101,13340
1,156682,156682,9138,524288,3048,1810,3226,3718,11802
5,160037,40799,5331,203161,2642,3211,2209,9798,17860
1,164502,164502,8226,524288,3568,2117,2341,3559,11585
1,169037,169037,9371,524288,1893,1708,2109,3450,9160
4,173286,52510,10038,274432,2762,1949,2220,8183,15114
2,176494,103599,18718,524288,6254,2064,2146,7074,17538
2,178337,104544,17776,524288,4724,2044,2147,7152,16067
2,181723,105397,17775,524288,3984,2149,2144,6650,14927
2,186279,106448,16427,524288,4015,1963,2148,6775,14901
2,192069,108574,15807,524288,3570,1977,2164,6881,14592
2,198194,110432,14236,524288,6434,2059,2190,6190,16873
2,202855,111320,12849,524288,6040,2044,2190,5922,16196
2,205603,111539,12659,786432,3514,2128,2201,8232,16075
2,207683,111687,11922,524288,3963,1970,2219,6684,14836
3,209040,73937,6981,264874,3208,1990,2497,5632,13327
3,210207,73818,6104,264874,5012,2052,2211,5121,14396
3,211157,73225,5764,221184,4216,2023,2233,5011,13483
1,212320,212320,7506,524288,2648,1826,2256,4638,11368
1,213942,213942,7406,524288,3214,2023,2307,3844,11388
2,214896,108074,4903,294912,1603,1999,2216,4636,10454
3,216960,78156,3620,267605,2693,2123,2326,5501,12643
1,217347,217347,7155,524288,3377,2080,2230,4443,12130
1,218052,218052,6759,524288,2124,1764,2207,3711,9806
2,217858,108936,3572,524288,2565,2035,2360,6230,13190
1,218310,218310,6047,524288,3861,1919,2237,3521,11538
1,218461,218461,6465,524288,2062,1963,2231,3760,10016
1,219008,219008,6300,524288,2010,1786,2196,3756,9748
1,218821,218821,6502,524288,1800,1741,2296,3510,9347
1,219546,219546,6361,524288,1844,1728,2193,3593,9358
1,220480,220480,5621,524288,1902,1794,2161,3464,9321
1,222836,222836,5557,524288,2364,2029,2208,3578,10179
1,223934,223934,11062,1048576,3361,1809,2188,5969,13327
1,224672,224672,10357,1048576,3425,1965,2436,6185,14011
1,224213,224213,11704,1048576,3778,1938,2213,6515,14444
2,223314,120092,6542,557056,6147,2120,2223,8748,19238
1,223012,223012,10453,1048576,4039,2008,2197,6181,14425
1,222635,222635,11247,1048576,3405,2082,2241,6437,14165
1,222420,222420,10660,1048576,3612,2080,2154,5794,13640
3,222386,80481,5160,524970,2968,1984,2389,9357,16698
1,222158,222158,10403,1048576,7247,2084,2200,6022,17553
1,219975,219975,10891,1048576,3031,1978,2181,6209,13399
1,218213,218213,11597,1048576,3603,1978,2218,6589,14388
1,216853,216853,10599,1048576,3095,1968,2190,5656,12909
1,214940,214940,10195,1048576,5668,3004,2285,6681,17638
1,213037,213037,10471,1048576,3737,2134,2176,5625,13672
1,211381,211381,10628,1048576,4745,1987,2210,7024,15966
1,211089,211089,9480,1048576,3657,1960,2612,6561,14790
3,210412,76972,4796,529749,3407,1985,2224,8540,16156
1,210446,210446,9950,1048576,3697,2170,2141,5498,13506
1,210840,210840,9712,1048576,2871,1986,2389,5793,13039
3,212781,78130,4767,360448,2714,1909,2319,7100,14042
3,214652,78705,4842,567978,3296,1991,2141,8850,16278
1,217996,217996,9312,1048576,4175,1766,2104,5864,13909
2,220334,119789,7194,786432,5637,2513,2215,7658,18023
2,224921,120403,7596,786432,4080,2029,2120,7918,16147
2,229310,120861,7737,655360,3714,1955,2091,6623,14383
2,234055,121365,7065,327680,4226,2053,2178,5074,13531
1,237226,237226,10933,524288,2637,1764,2103,4055,10559
1,238431,238431,10979,524288,2742,2029,2143,3886,10800
1,238919,238919,10646,524288,2023,1801,2100,3924,9848
1,238348,238348,10779,524288,2039,1755,2092,6925,12811
1,238921,238921,10427,524288,2462,2079,2620,4459,11620
1,238928,238928,10252,524288,2400,2001,2142,4215,10758
1,238788,238788,10891,524288,2228,1916,2187,4419,10750
1,238797,238797,10175,524288,1828,1799,2100,3817,9544
2,238461,120159,5760,270336,2013,1757,2145,4586,10501
1,238949,238949,10558,524288,2054,2083,2134,3883,10154
1,239118,239118,10420,524288,2630,1785,2146,4221,10782
1,238920,238920,11085,524288,2261,1774,2189,3956,10180
1,239345,239345,10383,524288,2450,1991,2099,3971,10511
1,239435,239435,9899,524288,1809,1726,2125,3903,9563
1,238926,238926,10499,524288,2032,1739,2104,4077,9952
1,239402,239402,9958,524288,2036,1785,2189,3798,9808
1,239469,239469,9675,524288,1744,1798,2147,3751,9440
1,239749,239749,9708,524288,2014,1974,2135,3812,9935
1,239807,239807,9740,524288,3234,2049,2125,5211,12619
1,240238,240238,10102,524288,3086,2042,2140,10970,18238
1,240888,240888,9259,524288,1920,1867,2490,4039,10316
1,240641,240641,9238,524288,2470,2061,2154,4016,10701
1,241053,241053,9785,524288,2813,1808,2136,3880,10637
1,242071,242071,8685,524288,1762,1738,2130,4016,9646
1,242319,242319,8477,524288,1973,1785,2187,4256,10201
1,242188,242188,9066,1048576,1974,1868,2118,5582,11542
1,242817,242817,8907,524288,5660,1961,2173,4019,13813
1,242915,242915,9337,1048576,3130,1907,2146,5966,13149
1,242700,242700,8982,524288,5583,2157,2198,4177,14115
1,242507,242507,9181,524288,3418,2056,2169,3967,11610
1,242819,242819,9591,524288,3643,2013,2178,4032,11866
1,242961,242961,9545,524288,3231,2020,2239,3900,11390
1,243241,243241,9182,524288,3323,1920,2137,6154,13534
1,243092,243092,9093,1048576,3404,2061,2156,5372,12993
1,243170,243170,9181,1048576,4428,2306,2223,6106,15063
1,242802,242802,8651,524288,2672,2042,2201,4229,11144
1,242992,242992,8652,524288,2566,2103,2517,4125,11311
1,242869,242869,8853,524288,2641,1816,2147,3907,10511
1,242983,242983,8484,524288,1956,1755,2152,4000,9863
1,242562,242562,8429,524288,2326,2059,2207,3849,10441
1,241862,241862,8675,524288,2376,1946,2146,4080,10548
1,241287,241287,8523,524288,2472,1827,2202,4200,10701
2,240552,120802,5422,278528,2030,1877,2160,4428,10495
1,240308,240308,8067,524288,4282,2093,2227,3981,12583
2,239921,120691,5533,278528,3458,2019,2188,4439,12104
1,240426,240426,8484,524288,2906,2011,2151,4273,11341
1,240619,240619,8414,524288,2339,2005,2146,4070,10560
1,240793,240793,8776,524288,1982,1716,2138,3700,9536
1,241432,241432,8548,524288,2250,2089,2235,4606,11180
1,242531,242531,8602,524288,2834,1996,2281,4067,11178
1,242778,242778,8817,524288,3369,1970,2120,3846,11305
1,242767,242767,8750,524288,1768,1762,2211,5472,11213
1,242891,242891,8743,524288,2399,2025,2140,4112,10676
1,243466,243466,8514,524288,1793,1770,2156,3783,9502
1,243793,243793,8535,524288,1992,1751,2127,4017,9887
1,244120,244120,7926,524288,2380,2319,2176,4251,11126
1,243728,243728,8330,524288,1932,1768,2118,3823,9641
1,243574,243574,8598,524288,2349,1972,2142,3749,10212
1,243747,243747,8955,524288,2156,1804,2115,3979,10054
1,243559,243559,8402,524288,2263,1735,2401,3671,10070
1,243736,243736,8402,524288,1777,1811,2101,3778,9467
1,244072,244072,8437,524288,2606,2034,2159,4542,11341
1,243753,243753,8701,524288,3227,1918,2169,3995,11309
1,243985,243985,8643,524288,3203,1993,2178,3799,11173
1,243969,243969,8596,524288,1743,1789,2191,3882,9605
1,243500,243500,9095,524288,4460,1774,2193,3886,12313
1,243849,243849,9244,524288,3339,1905,2156,3517,10917
1,244307,244307,8387,524288,2015,1742,2238,3804,9799
2,244247,122191,4377,266240,1886,1712,2197,4121,9916
1,244353,244353,8015,524288,3418,1966,2184,3655,11223
1,244435,244435,8237,524288,3157,2061,2192,3617,11027
1,244025,244025,8409,524288,3313,1923,2140,3624,11000
1,244665,244665,7686,524288,2072,1821,2145,3821,9859
1,244383,244383,7675,524288,2196,1824,2195,3605,9820
2,244426,124291,5449,294912,2343,1953,2221,4847,11364
1,244646,244646,7822,524288,2157,1963,2170,3617,9907
1,244523,244523,8085,524288,1985,1790,2209,3642,9626
1,244557,244557,8039,524288,3335,1970,2250,3873,11428
2,244442,122787,5155,278528,3298,2101,2255,4654,12308
1,244033,244033,7519,524288,3890,1940,2222,3928,11980
1,244235,244235,7433,524288,2848,2026,2184,4164,11222
1,244451,244451,7145,524288,3197,1989,2223,3671,11080
1,244264,244264,7598,524288,3482,1929,2174,3917,11502
1,243986,243986,7628,524288,1827,1713,2154,4144,9838
1,243313,243313,7752,524288,2917,1952,2183,3877,10929
1,236352,236352,8069,524288,3233,2006,2233,3717,11189
1,225546,225546,8055,524288,3104,1921,2260,3782,11067
1,216725,216725,7610,524288,2825,1958,2281,3637,10701
1,209660,209660,7451,524288,2717,1820,2305,3575,10417
1,201570,201570,7225,524288,2332,1948,2308,3735,10323
2,193816,118784,5273,327680,2481,2108,2255,4966,11810
2,187316,119307,5448,327680,4525,2104,2322,4589,13540
2,179886,116874,5306,393216,3186,1959,2276,5073,12494
2,172012,90282,4561,278528,3255,2140,2560,4579,12534
2,163821,90997,4609,294912,3076,2016,2562,4204,11858
2,148268,92257,4463,327680,2090,2073,2466,9320,15949
2,140548,92767,4427,393216,2067,1711,2804,6316,12898
2,132814,93302,4587,262144,3198,1958,2552,4024,11732
2,125880,93903,4616,262144,2123,1716,2323,4403,10565
2,119320,94276,4316,262144,3516,1987,2326,4042,11871
2,112437,93561,4523,262144,3234,2083,2403,4445,12165
2,106746,91323,4824,262144,4000,1996,2307,4027,12330
2,98990,87291,4677,262144,2766,1826,2328,4012,10932
4,91308,57879,4105,180224,3001,2133,2729,7096,14959
4,78222,58151,4306,425984,3371,2026,2399,10281,18077
2,78305,75437,4721,262144,4495,1944,2297,4047,12783
4,78018,57868,4639,196608,2354,1975,2269,6308,12906
4,78688,57994,4638,229376,3649,2060,2453,6474,14636
3,79340,45714,4364,305834,2986,2062,2304,6172,13524
4,79482,58228,4557,229376,3719,2097,2259,6832,14907
4,79812,57847,4744,229376,4132,1879,2213,6480,14704
5,80082,47297,4882,288358,3700,2101,2281,9150,17232
4,82594,57972,4968,229376,5205,1866,2187,7937,17195
4,90634,58463,4898,212992,3191,2027,2336,6555,14109
1,83328,83328,4362,262144,2699,1957,2337,2523,9516
3,103960,77985,5194,262144,1610,1715,2209,5393,10927
3,109516,79602,5325,349525,4593,2108,2267,7842,16810
3,113838,80478,5127,349525,5151,2068,2192,6636,16047
3,118933,81000,5279,349525,6230,1799,2170,6710,16909
3,123562,80980,5274,611669,3642,1760,2135,10046,17583
1,126589,126589,9091,524288,5934,1859,2199,3515,13507
3,130208,73411,4699,349525,3331,1820,2223,6260,13634
3,134854,74934,4611,305834,3821,2060,2367,7605,15853
2,138677,114430,7211,393216,3079,1752,2683,5344,12858
2,142276,116238,7577,393216,2474,1760,2396,5005,11635
2,144824,116894,7667,393216,4410,1986,2129,5482,14007
2,146256,116636,7682,393216,4585,1841,2108,5421,13955
2,147708,115893,7678,393216,5001,1783,2111,4986,13881
1,147721,147721,11728,524288,4366,1797,2113,3981,12257
1,147602,147602,10467,524288,3713,1696,2040,3736,11185
3,147763,74512,5325,350208,1828,1750,2253,6419,12250
3,147316,73259,5407,283989,5888,1761,2130,5871,15650
3,147356,72218,5839,283989,5145,1769,2116,7253,16283
3,147538,72466,7125,349525,5379,1836,2128,7139,16482
3,148226,69951,5760,535210,6230,1834,2100,8895,19059
3,147914,68484,6256,267605,5192,1818,2022,5600,14632
3,149189,67124,5894,267605,2883,1746,2056,6635,13320
3,151982,66279,6730,458752,2450,1759,2124,8347,14680
3,156145,65565,7109,447829,4306,2609,2042,9933,18890
3,163927,65667,7404,458752,3938,1817,2045,8296,16096
3,171436,65474,7699,458752,11001,1783,2066,9379,24229
3,179211,63240,7368,546133,5248,1965,2087,11149,20449
1,177992,177992,18660,1048576,4363,1795,2027,5962,14147
2,173688,89990,12607,786432,2880,1725,2233,8695,15533
2,167756,87068,13036,786432,6668,1851,2119,9460,20098
2,159561,82990,13450,655360,7156,1815,2137,7352,18460
2,151327,79096,11286,655360,4037,1794,2067,8163,16061
3,143037,50125,7492,442368,4171,1786,2064,11636,19657
2,136632,72069,10974,655360,3935,1715,2063,6814,14527
4,128884,38887,9482,466944,4476,1816,2099,10292,18683
2,122707,64902,14140,786432,8618,1856,2120,8060,20654
2,116450,61981,10019,655360,7235,1795,2118,6960,18108
5,109612,31832,7274,396492,3853,1847,2070,12410,20180
5,100304,29890,6542,393216,7722,2023,2381,10483,22609
5,90079,30040,7074,734003,11498,1908,2131,26882,42419
5,72554,26064,7243,422707,9838,1861,2148,10998,24845
4,65849,24170,5700,397312,9525,1820,2108,8273,21726
2,15636,10741,6532,196608,6218,1815,2054,3770,13857
0,0,0,0,0,2932,1812,2031,436,7211
6,45140,20123,7338,612010,533,1698,2089,18183,22503
5,34456,9480,3318,386662,13205,1808,2072,11337,28422
7,34324,12402,3412,711533,5543,1834,2066,27398,36841
1,10044,10044,16692,1048576,15039,1998,1963,5064,24064
3,37338,20098,11895,567978,2758,1754,1984,8984,15480
4,38004,17236,4774,409600,5388,1794,2037,9281,18500
6,29219,15289,8314,589824,8357,1786,2053,17970,30166
6,21545,8460,5756,764586,11631,1803,2017,25414,40865
5,38361,20121,6034,288358,10918,4506,2069,22399,39892
4,38449,23875,8424,557056,7877,1983,2044,12208,24112
4,37236,23192,5009,294912,9734,1782,2008,7358,20882
6,27093,11990,5963,633514,4543,1826,2216,20297,28882
5,25653,10808,2920,341606,12535,1878,2038,10029,26480
4,30677,16138,4847,819200,4583,1874,2005,15236,23698
3,29035,19315,5523,567978,10834,1853,2005,8353,23045
6,27341,12384,4169,447829,7943,1939,2115,16294,28291
5,22713,15015,5252,445644,6900,1811,2040,11886,22637
6,23220,12912,4900,415061,5369,1794,2104,14415,23682
7,25866,11685,3657,374491,6760,1880,2112,14479,25231
8,30551,9723,4597,344064,5764,1781,2138,16712,26395
7,35064,11954,4287,458752,11630,1945,2336,19444,35355
4,43196,19526,6240,589824,12080,1856,3574,12806,30316
5,47124,16554,5544,734003,9350,1800,2460,18118,31728
6,52766,14685,3999,502442,8283,1824,2311,15653,28071
5,55300,18910,5833,471859,9329,1943,2164,14830,28266
5,58567,18742,5368,642252,9270,1839,2149,15102,28360
3,65789,32403,6465,393216,10796,1819,2114,7057,21786
2,70090,46813,8381,524288,3619,1724,2183,6819,14345
2,75981,50688,8721,524288,4066,1829,2277,6520,14692
6,80798,18083,2977,240298,4039,1921,2219,10656,18835
4,83451,27259,5733,655360,4897,1827,2130,15288,24142
5,83783,24952,6856,655360,6938,1733,2189,16798,27658
5,81545,25202,9059,576716,11709,1893,2228,16534,32364
6,78848,23500,6757,459093,10698,1848,2741,16422,31709
6,81127,23673,5890,546133,12636,1859,2531,16762,33788
7,86133,21944,6065,589824,9880,1824,2407,20928,35039
5,87016,27742,7378,589824,12801,2082,2277,15452,32612
6,92145,24775,7547,535210,8040,1830,2205,16970,29045
7,95783,23737,5609,444708,12863,1856,2235,16904,33858
6,104027,27841,6585,491520,8126,1907,2203,15740,27976
6,109035,28556,6391,513365,7108,1832,2461,15101,26502
6,108010,28278,6692,447829,12314,1860,2241,13786,30201
7,96970,23502,6049,514925,7100,1889,2228,21643,32860
6,94862,28043,5912,404138,14392,3250,2405,13967,34014
5,89643,29915,5792,471859,7463,1785,2277,15848,27373
7,85004,21580,4068,449974,5717,1866,2262,16426,26271
7,79699,20928,4096,365129,13161,1901,2250,14172,31484
8,66994,17720,4607,458752,6799,3064,2298,23635,35796
9,61985,16117,4937,509724,11639,1969,2291,22750,38649
3,55597,26457,4072,567978,12977,1948,2301,8829,26055
10,55102,13428,4393,386867,5081,1822,2236,21055,30194
12,54749,11537,4502,382293,9408,1880,2278,26096,39662
10,53255,11972,5058,340787,16635,1862,2201,20480,41178
10,48900,11913,4995,433356,9603,1813,2232,23876,37524
10,49302,12781,5325,406323,10680,1853,2262,30050,44845
9,44406,13587,4902,444188,12680,1856,2344,22850,39730
11,42299,12268,4921,434920,16042,1877,2296,26313,46528
6,27915,13213,6315,447829,14862,1876,2143,14722,33603
8,43764,15370,5863,475136,7681,1804,2229,21134,32848
8,45473,16571,6014,475136,13040,1845,2237,21762,38884
8,47855,16646,5215,376832,11627,2685,2265,22597,39174
9,49640,13872,5233,451470,11419,1839,2206,21640,37104
7,53922,16328,9206,496201,15405,1969,2092,21029,40495
5,92239,23216,8010,734003,10504,1906,2124,18665,33199
7,109223,19922,4662,458752,12731,1845,2326,19813,36715
2,157351,81242,4557,786432,8926,1844,2363,8181,21314
1,172267,172267,6995,1048576,8008,1766,2229,5570,17573
1,185262,185262,6718,1048576,5285,1718,2176,5461,14640
1,196686,196686,6087,524288,2826,1775,2249,3574,10424
1,204299,204299,5987,524288,1987,1756,2308,3603,9654
2,210941,105474,2914,270336,1773,1722,2322,3984,9801
1,217451,217451,5895,524288,1786,1710,2293,3479,9268
1,222244,222244,5993,1048576,1841,1709,2348,5255,11153
1,224697,224697,6374,1048576,2810,1724,2307,5677,12518
1,225241,225241,6320,1048576,5107,1803,2619,5766,15295
1,225172,225172,6258,1048576,4591,1815,2305,5723,14434
1,225031,225031,5913,1048576,3365,1894,3361,5748,14368
1,224811,224811,5700,524288,2986,1748,2330,4168,11232
1,224434,224434,5811,524288,3181,1759,2448,4197,11585
1,224373,224373,5688,524288,3004,1742,2415,3813,10974
1,226139,226139,5588,524288,3156,1716,2305,3936,11113
1,226886,226886,5513,524288,3359,1743,2317,3913,11332
1,225294,225294,5642,524288,3202,1699,2249,3822,10972
1,222076,222076,5724,524288,3539,1803,2255,5588,13185
1,218001,218001,5631,524288,3510,1729,2246,3828,11313
2,214475,109899,4086,294912,3869,1746,2312,5065,12992
2,210197,106136,3543,540672,3992,1713,2311,6267,14283
3,206057,73330,3803,415061,6008,2012,2420,7410,17850
3,201658,73182,4310,262144,6622,1800,2309,6951,17682
2,196823,100327,4027,589824,4461,1906,2610,6446,15423
2,191842,98026,4048,589824,5190,1771,2482,6448,15891
3,185530,72405,5207,436906,6210,1811,2244,15291,25556
4,171442,53089,3676,304128,4258,1835,2284,8348,16725
4,165016,52420,4117,315392,7230,1822,2324,14275,25651
3,159585,67299,5442,305834,3929,1786,2435,9890,18040
4,154683,50763,4799,231424,3089,1781,2214,6778,13862
5,149805,40617,4443,396492,5696,1817,2235,14463,24211
5,144081,39985,4768,394854,5355,1855,2593,11574,21377
5,138323,39787,4464,270336,6505,1783,3644,9751,21683
5,131573,39317,4799,275251,3966,1714,2302,9834,17816
6,124967,32903,4565,229376,4671,1792,2269,10499,19231
5,118434,38466,4956,386662,7673,1745,2254,12313,23985
5,112014,38225,5209,452198,4839,1741,2484,12077,21141
5,106792,36566,5149,439091,6088,1759,2224,12158,22229
5,103032,36175,5312,429260,6274,1900,2295,12300,22769
6,99718,29949,4903,447829,7946,1805,2274,17278,29303
3,95565,56038,8183,699050,15067,1965,2274,10978,30284
5,84357,34843,6069,445644,7842,1823,2250,15414,27329
5,76396,34493,6527,550502,9023,1831,2225,14921,28000
3,61075,46349,8396,699050,10305,1831,2237,12406,26779
5,60782,32430,5355,498073,4961,2045,2272,13336,22614
6,57793,26011,4401,458752,7396,1875,2264,14555,26090
5,56218,30544,4922,498073,11818,1822,2274,12441,28355
3,48251,35325,7503,524288,9369,1775,2206,9467,22817
3,49225,35341,7259,524288,4052,1740,2133,8934,16859
0,0,0,0,0,7648,1778,2137,499,12062
5,54472,27457,5066,301465,611,1758,2223,8657,13249
1,37278,37278,4315,262144,8282,1868,2190,2256,14596
1,34097,34097,4224,262144,1632,1701,2179,2357,7869
5,42127,23810,5985,524288,1389,1741,2114,13649,18893
5,34203,19537,5822,760217,11020,1865,2605,27006,42496
3,37260,25006,4920,371370,10580,1829,2311,7118,21838
10,44626,12849,5672,540672,5851,1745,2328,31138,41062
10,56195,14298,6535,734822,18179,1888,2358,42840,65265
8,72590,19288,5021,638976,22502,1950,2321,25594,52367
6,92851,27471,6972,546133,18773,1971,2120,19231,42095
8,115026,21301,5409,413696,10685,1786,2357,18399,33227
4,117874,37342,4622,458752,11831,1785,2360,11559,27535
8,115986,22640,5202,598016,4873,1792,2324,29158,38147
8,111938,23106,6143,802816,17198,1945,2287,34721,56151
8,113617,23362,4413,458752,16572,1881,2293,20859,41605
6,116510,30464,4285,557056,12892,1844,2328,19976,37040
7,115426,26623,3904,402578,14381,1940,2319,14498,33138
5,115546,36492,4052,439091,7519,1801,2222,12226,23768
4,114114,45432,5677,655360,8014,1771,2223,18673,30681
4,111310,44494,4668,655360,7166,1812,2206,14288,25472
4,107639,44338,5152,589824,8979,1883,2255,12304,25421
1,103132,103132,5325,524288,8735,1777,2446,3353,16311
4,99808,42940,4665,720896,2798,1841,2265,16475,23379
8,98292,23650,4753,573440,8083,1868,2342,27460,39753
6,96167,30154,3714,442368,20768,1825,2311,15993,40897
8,91434,23428,4277,290816,9071,1842,2366,15682,28961
5,88690,35504,4084,478412,11081,1803,2255,14937,30076
5,85627,36451,4503,301465,8896,1764,2253,10109,23022
4,89014,45849,4982,368640,4053,1868,2811,9637,18369
3,91635,60181,5881,447829,7217,1829,2237,11176,22459
4,94002,46080,5079,368640,4506,1751,2243,9081,17581
5,96780,37453,4966,373555,6871,1820,2297,11277,22265
5,99689,40158,5840,373555,5521,1778,2273,12098,21670
6,104750,32318,5003,458752,4973,2045,2315,14419,23752
5,110760,39020,5523,629145,9339,1883,2289,16466,29977
4,114356,47802,5735,491520,10536,1955,2311,10525,25327
5,116377,39424,6022,484966,11515,1814,2465,15313,31107
3,119487,45655,7365,720896,6453,1868,2357,11977,22655
3,121321,45269,6899,535210,9606,1869,2348,9322,23145
5,123417,37966,3168,393216,6268,1831,2355,11027,21481
1,129893,129893,5157,524288,7578,1785,2265,3446,15074
1,134787,134787,11709,1048576,3399,1706,2233,5688,13026
1,137825,137825,11878,1048576,4749,1840,2369,6220,15178
1,137861,137861,5695,524288,3025,1791,2237,3544,10597
1,139063,139063,5687,524288,3214,1781,2255,3691,10941
1,142011,142011,12971,1048576,1907,1801,2257,6124,12089
1,143754,143754,13278,1048576,3746,1792,2356,5798,13692
1,146958,146958,13503,1048576,3817,1857,2267,5946,13887
1,149792,149792,14123,1048576,5581,1813,2274,7544,17212
1,152198,152198,13666,1048576,7236,2680,2459,5843,18218
1,153012,153012,12655,1048576,9266,1930,2260,5723,19179
1,155118,155118,12240,1048576,8927,3124,2308,6305,20664
1,154899,154899,12004,1048576,5300,1823,2439,6545,16107
1,154257,154257,11442,1048576,5764,1835,2384,5716,15699
1,144027,144027,13693,1048576,3565,1774,2390,6031,13760
1,153016,153016,12224,1048576,2949,1854,2311,5931,13045
1,153372,153372,12424,1048576,5290,1796,2838,6985,16909
1,153737,153737,11904,1048576,3469,1855,2509,6649,14482
1,153274,153274,11641,1048576,3864,1732,2348,6144,14088
1,152235,152235,11957,1048576,3829,1799,2337,9318,17283
1,150629,150629,11822,1048576,4061,1784,2318,6099,14262
1,150198,150198,11933,1048576,3107,1753,2227,5969,13056
1,152917,152917,12728,1048576,5484,1707,2211,5594,14996
2,149622,108311,7702,655360,3088,1819,2292,7772,14971
2,147072,110726,7980,655360,5544,1810,2279,7716,17349
2,141368,111219,7966,655360,5286,1790,2288,7537,16901
2,134532,111220,7772,655360,6773,1763,2288,8943,19767
3,127574,74419,5563,442368,5327,1762,2252,7839,17180
3,122132,74339,5362,439637,7154,1751,2302,8113,19320
3,114854,74889,6512,283989,3841,1789,2274,6487,14391
4,114369,56447,5058,217088,7112,1774,2328,7092,18306
4,118256,56913,5388,229376,5669,1931,2454,8481,18535
3,119748,75034,6170,283989,5325,1735,2265,6469,15794
2,120772,112070,4331,655360,3415,1744,2274,7369,14802
3,122084,75277,6055,283989,3910,1752,2272,6348,14282
2,122674,112091,4295,655360,2872,1702,2224,7341,14139
2,119524,112297,7907,393216,3497,1728,2216,6173,13614
3,118323,76846,5635,267605,3985,1763,2296,7769,15813
2,133330,116617,5010,393216,5524,1843,2245,5914,15526
2,140910,115864,4696,393216,3029,1825,2202,5825,12881
3,143179,76453,4046,273066,4728,1707,2287,5387,14109
2,147644,76002,4870,393216,5259,1741,2200,4514,13714
1,138239,138239,12822,1048576,2535,1759,2254,5609,12157
1,128378,128378,13164,1048576,2780,1790,2278,6060,12908
2,122719,103322,8780,655360,3345,1823,2449,7533,15150
2,118941,103962,4634,393216,3593,1800,2340,5144,12877
2,122947,104663,5162,393216,4447,1844,2258,5388,13937
1,130960,130960,12408,1048576,4813,1866,2282,6225,15186
1,128601,128601,5954,524288,6466,1836,2305,3395,14002
1,116435,116435,6319,524288,3136,1812,2432,4290,11670
1,111577,111577,5973,524288,1890,1798,2194,3259,9141
1,108370,108370,6209,524288,3290,1732,2236,3653,10911
1,106963,106963,6261,524288,1905,2048,2250,3265,9468
1,105249,105249,6067,524288,1969,2003,2411,3298,9681
1,103142,103142,6154,524288,1837,1775,2257,4037,9906
1,101271,101271,6129,524288,2711,1794,2406,3746,10657
1,100040,100040,6359,524288,1964,1711,2258,3637,9570
1,97919,97919,6462,524288,3218,1782,2263,3417,10680
2,96736,87427,5284,393216,2032,1846,2200,4537,10615
2,94790,87015,5665,393216,2119,1710,2170,5047,11046
2,93768,86473,5613,393216,4405,1757,2246,5354,13762
2,91780,85145,5420,393216,4670,1791,2219,4682,13362
1,93565,93565,6397,524288,4285,1704,2224,3258,11471
1,93857,93857,14377,1048576,3273,1738,2240,5911,13162
1,92378,92378,14706,1048576,5565,2081,2153,5886,15685
1,88803,88803,14370,1048576,3185,1754,2101,5568,12608
2,80157,67280,6023,393216,3781,1764,2084,4438,12067
3,77809,50996,4894,360448,2435,1754,2103,5784,12076
3,98439,56137,4645,273066,3085,1699,2123,5201,12108
3,122299,64235,4741,273066,2603,1710,2177,5341,11831
3,140543,70318,6920,699050,2657,1702,2185,10920,17464
3,138420,70313,4618,273066,10682,1815,2203,5730,20430
3,127204,69735,5290,699050,4766,1728,2246,10248,18988
2,118710,98127,5650,524288,4561,1949,2186,6261,14957
3,103634,67190,6474,699050,5911,1767,2183,10381,20242
3,95765,66537,6778,699050,5046,1764,2192,11184,20186
6,88726,34112,7432,699050,6431,1779,2204,22035,32449
3,81054,65895,6294,436906,16778,1835,2179,7337,28129
3,72993,63097,7079,349525,4628,1781,2175,6291,14875
3,74178,62826,7287,349525,3639,1796,2144,6673,14252
4,77267,48364,5757,393216,5669,1707,2194,8881,18451
3,77694,63541,7141,262144,4952,1777,2130,5421,14280
3,79482,63601,7261,262144,2763,2052,2166,5418,12399
3,80075,63246,7059,349525,2315,2001,2116,5963,12395
3,80278,62938,7329,349525,4123,1987,2239,6423,14772
3,81162,62995,7401,349525,5270,1951,2252,6815,16288
3,82433,62861,7402,349525,5243,2065,2218,13560,23086
3,82927,62879,7410,349525,5617,2127,2567,6309,16620
4,83811,47931,5911,294912,3819,1876,2177,8333,16205
3,81809,62973,7153,349525,3530,2032,2157,6175,13894
2,56028,53645,8300,262144,5677,1962,2201,4016,13856
3,78229,61651,7930,349525,2899,1775,2127,5963,12764
3,78097,61213,7861,349525,5191,2057,2153,7767,17168
4,78094,46581,7648,409600,2944,1955,2143,9451,16493
4,77217,46760,6940,278528,5528,1975,2175,8329,18007
5,78135,39248,7687,314572,4946,1793,2179,9698,18616
5,77008,38756,7797,314572,7047,2003,2156,9391,20597
3,73574,58532,12328,436906,8858,2021,2156,7748,20783
3,70261,57971,9814,349525,4470,1846,2111,6480,14907
4,69362,46949,10057,327680,6502,1957,2167,9378,20004
5,71067,38135,8755,314572,5614,2073,2311,15390,25388
4,72976,45267,10916,327680,7890,2175,2160,8907,21132
3,75778,57470,9643,349525,3889,2072,2183,6693,14837
4,82113,45347,6976,327680,5041,2139,2260,9321,18761
4,89817,47290,7083,327680,7219,1803,2803,7972,19797
3,96208,62805,8431,349525,6277,2141,2181,6575,17174
4,100959,48819,6871,327680,4305,2009,2297,8296,16907
3,99707,54708,8666,349525,5945,1786,2101,6135,15967
2,93042,57296,7690,393216,3996,2000,2075,4862,12933
1,82376,82376,6667,524288,2311,1928,2215,2902,9356
1,70861,70861,5365,524288,1947,1793,2021,3086,8847
4,62755,29911,8814,524288,2802,2065,2122,11302,18291
4,59083,31298,8081,458752,9803,2032,2066,10131,24032
3,51520,38541,8209,611669,4866,1961,2040,10179,19046
4,47838,29546,7519,589824,5616,2131,2150,14207,24104
4,57610,30051,8204,589824,6914,3001,2079,15527,27521
4,75045,32651,8996,720896,8528,1986,2078,15619,28211
3,80118,42774,7974,611669,7535,2049,2123,10194,21901
3,79826,42190,7981,524288,4949,2050,2095,9177,18271
5,66658,32292,8422,471859,4378,1787,2086,13928,22179
5,67444,30459,6333,425984,6365,1911,2088,13502,23866
6,72102,26784,7649,611669,8742,1995,2058,17947,30742
2,69969,39760,8315,786432,10562,2325,2141,8454,23482
3,67232,45662,12665,699050,6564,2074,2009,11417,22064
5,57408,27643,8559,629145,5109,2066,2049,17030,26254
6,57250,24610,6527,480597,7415,2008,2043,15059,26525
5,60524,28755,8061,629145,8140,1821,2054,21379,33394
5,55734,27257,7158,471859,8912,2156,2427,12589,26084
6,59926,24758,6565,436906,8419,1820,2107,16173,28519
6,69784,24094,6542,567978,9188,2083,2115,19084,32470
5,71939,26197,6207,471859,11294,2190,2099,13486,29069
9,67362,14469,5579,393216,6387,2044,2139,20270,30840
6,65647,21663,6151,567978,14698,1998,2083,18745,37524
8,56754,17240,5078,393216,9314,1833,2264,17843,31254
9,58276,15808,5630,560696,10258,1841,2148,27365,41612
8,61185,17337,4332,475136,16942,1870,2142,21437,42391
6,66409,18612,5308,415061,10085,1918,2100,15952,30055
6,62671,20341,6700,349525,8255,1883,2061,13256,25455
6,55447,20906,5143,338602,6976,1839,2164,16255,27234
6,55575,20400,5711,360448,11867,1886,2149,12548,28450
6,53862,21624,7591,524288,6665,1875,2090,17108,27738
6,52735,21945,7367,524288,8371,1805,2075,17222,29473
6,49373,21016,7327,524288,11956,1817,2057,18583,34413
3,53329,36380,8482,436906,10279,1811,2103,8334,22527
3,54673,32293,8714,436906,3720,1937,2258,7451,15366
5,33389,19858,5664,445644,6085,1757,2088,11882,21812
4,39173,23448,8304,458752,5388,1738,2048,10267,19441
5,41267,15408,6901,380108,7214,1767,2128,11897,23006
5,34862,18228,5778,399769,5190,1795,2157,11729,20871
5,32779,21047,6572,373555,5733,1805,2384,10838,20760
4,32671,25457,8159,589824,5959,1816,2061,19219,29055
4,33140,24218,8311,458752,10443,1804,2066,10579,24892
4,39476,19177,7703,344064,7720,1777,2004,8236,19737
3,23465,13710,6705,699050,4611,1740,2069,11124,19544
0,0,0,0,0,5740,1950,2074,344,10108
0,0,0,0,0,601,1720,2080,450,4851
3,32099,24636,8665,436906,433,1699,2003,8085,12220
3,30268,24725,9466,436906,4939,1805,1997,7344,16085
1,18952,18952,25326,524288,4783,2160,1938,3325,12206
1,19963,19963,25233,524288,2394,1769,1990,3693,9846
1,21520,21520,26735,524288,2011,1717,1931,3381,9040
3,21456,18087,14862,524288,1906,1716,1949,8935,14506
3,23512,19352,13991,524288,4287,1762,2039,9019,17107
3,28994,21392,14032,699050,6754,1886,2002,11745,22387
4,27708,18774,9144,393216,5198,1828,2063,14017,23106
4,32362,22110,9302,393216,5179,2042,2134,9081,18436
4,29121,19218,10376,344064,4307,1768,2023,8478,16576
5,21890,12712,8046,458752,5912,1865,2016,11489,21282
5,26406,18129,10690,576716,7155,1791,2096,17502,28544
3,26909,14099,8455,524288,13402,1794,2058,8595,25849
5,28224,17247,9439,393216,6771,1898,2178,11635,22482
5,24609,18217,15685,340787,9232,2516,2097,11194,25039
5,29542,15322,9477,471859,7909,1764,2062,12558,24293
4,28758,12745,10603,458752,5746,1828,1965,10335,19874
2,30861,20948,13218,524288,5580,1749,1925,5917,15171
5,22092,11630,4761,432537,3624,1766,2002,11524,18916
5,20842,12138,9148,498073,5571,1863,2192,15484,25110
5,23134,11279,4912,655360,9032,2815,2217,17530,31594
4,18062,11412,5292,327680,17058,2647,1993,8445,30143
8,17578,10721,7280,507904,6361,1832,2063,26310,36566
11,15695,8648,4355,536203,14815,2254,2161,28444,47674
7,29704,12612,5382,318317,18923,1835,2158,15554,38470
6,47569,16162,6108,415061,6750,1757,2112,14894,25513
6,54728,14475,6555,415061,6044,1809,2069,14243,24165
3,61363,25952,6706,393216,6653,1795,2034,7164,17646
3,67879,28617,8100,611669,3537,1824,2000,9653,17014
5,75048,20599,5381,550502,4332,1723,2035,13357,21447
2,83680,48975,10786,786432,6145,1757,2052,8136,18090
3,91708,38890,9543,699050,5556,1789,2076,11250,20671
3,97709,42266,11299,873813,7644,1817,2069,14300,25830
4,100754,32715,7396,425984,7448,1844,2741,9820,21853
9,102978,16498,4041,265784,6241,1762,2177,20442,30622
9,102752,16768,4174,302193,10672,1894,2252,15590,30408
8,103423,19018,4648,235520,7712,1847,2223,12369,24151
8,105328,19885,4906,450560,9155,1853,2177,18226,31411
7,99598,22449,5216,402578,8694,1916,2127,17013,29750
10,96836,16040,4752,393216,8960,1785,2270,20219,33234
10,94429,15945,5120,501760,11789,1752,2380,25584,41505
9,87761,16840,5633,543402,11189,1772,2185,24990,40136
5,78346,21345,4345,537395,16518,1872,2156,14853,35399
11,66782,12333,4897,551098,7568,1792,2288,36707,48355
6,58755,17222,6573,524288,28591,1987,2265,19915,52758
8,47239,12434,5239,573440,12984,2600,2228,22615,40427
12,37681,11017,3248,363178,11000,1820,2938,23479,39237
11,40768,11964,4052,372363,12733,1837,2201,22979,39750
11,36807,11913,4455,332148,13995,1912,2197,19477,37581
3,21869,9879,2288,611669,17407,1942,2267,9924,31540
11,23840,10803,3912,312785,6161,1779,2172,18618,28730
10,19667,12014,4307,347340,8652,1853,2154,18911,31570
4,26447,14487,5140,557056,9195,1813,2176,11737,24921
3,31771,18002,5781,699050,8418,2356,2397,10088,23259
6,25552,14037,4929,502442,7422,1783,2252,16355,27812
7,26483,14568,4913,449389,8722,1821,2241,20432,33216
12,23196,10730,3766,347136,8789,1796,2490,21610,34685
10,28244,10326,3987,275251,10084,1823,2128,15758,29793
8,24980,13024,5229,342016,8698,1851,2119,14632,27300
10,29483,11707,4133,317849,11062,1821,2138,16989,32010
10,30269,11570,5183,448921,8512,2117,2206,26197,39032
7,34128,14786,4594,360448,15489,1890,2082,16858,36319
3,37156,23070,8941,786432,7346,1855,2132,13040,24373
7,37416,16140,5170,397897,8983,1761,2103,14316,27163
6,38445,17571,6475,611669,14997,1943,2067,18125,37132
6,37708,15710,5423,589824,14363,3322,2324,25196,45205
6,39706,14078,5023,557056,8533,1808,2334,17354,30029
5,41586,15736,8039,740556,8756,1796,2245,17828,30625
7,44976,15931,4860,601526,12073,1778,2120,22670,38641
8,46048,12612,4613,591872,14326,1819,2167,22374,40686
10,49012,12488,6866,589824,16549,2787,2224,33290,54850
5,51387,18854,8042,891289,19136,1881,2149,25151,48317
6,53404,18241,8622,917504,14400,1853,2084,26535,44872
7,46010,19206,9443,636635,17024,1839,2083,22861,43807
7,48607,20909,7843,748982,17388,1810,2099,31343,52640
4,48891,25969,9320,671744,13205,1810,2056,15640,32711
5,55245,24897,7877,734003,9151,1735,1996,18199,31081
8,53975,15634,6169,458752,11131,1811,2080,19469,34491
7,57061,18547,8376,365129,10198,1863,2078,15076,29215
7,49775,21210,9608,477476,11439,1825,2089,19751,35104
5,73174,30007,9364,419430,9798,1900,2093,14647,28438
4,74149,38676,11077,606208,6899,1775,2066,12170,22910
4,79263,40517,13230,655360,8304,1775,2486,13289,25854
5,80941,36390,9909,530841,8050,3000,2369,14903,28322
4,78646,38619,10895,591872,11826,1767,2039,18365,33997
5,73696,35789,8304,543948,9772,1904,2098,16261,30035
4,71392,43905,9467,688128,12637,1803,2097,14044,30581
6,70650,30327,7012,471040,9295,1779,2130,14520,27724
4,72527,35812,9223,557056,12174,4561,2207,12353,31295
4,72595,34692,9050,548864,9296,1761,2081,11511,24649
4,73907,34647,8933,598016,5710,1777,2068,13927,23482
5,75637,33057,9073,707788,6476,1871,2062,19034,29443
5,76251,31295,8124,737280,12062,1832,2071,17470,33435
6,71746,30968,7530,502442,9512,1806,2112,16716,30146
5,73762,37771,8706,629145,12125,1841,2131,15898,31995
5,71568,37848,8189,589824,10025,1990,2309,21204,35528
5,68396,33015,8374,602931,8477,2687,2149,15325,28638
4,67416,39678,8983,688128,12709,1896,2054,13609,30268
5,68683,32500,7499,557056,7140,1790,2048,15772,26750
4,69260,39617,8556,663552,8343,1731,2066,13307,25447
4,69456,39126,8602,532480,7315,1848,2357,11562,23082
4,70745,38828,8588,540672,9886,1818,2022,12816,26542
4,73061,39102,8073,540672,6532,1762,2055,11982,22331
4,73669,38916,8142,540672,5853,1794,2000,12006,21653
4,73677,38558,8331,475136,5966,1831,2156,10909,20862
5,72520,39229,7664,445644,5443,1773,2056,14059,23331
4,74010,38527,8006,442368,6387,1816,2038,10131,20372
4,74352,38624,7584,442368,8228,1829,2058,11054,23169
4,74358,37606,8184,442368,6421,1833,2036,11339,21629
3,75025,46175,9773,567978,10105,1859,2135,10594,24693
3,76473,46569,8943,546133,5064,1757,2089,9558,18468
4,74993,49147,8402,540672,4512,1743,2433,11431,20119
4,74792,49304,8507,540672,6231,1903,2244,12513,22891
4,74700,49477,8229,589824,8894,1862,2232,13406,26394
5,74344,41838,7157,458752,8517,1769,2244,12922,25452
5,75174,40320,7229,439091,9898,1826,2230,12523,26477
4,76893,50638,7886,589824,6639,1807,2172,13079,23697
4,78549,51398,8027,540672,7045,1817,2230,12791,23883
5,80812,42501,6422,452198,8225,1795,2202,13271,25493
5,82281,42605,6884,471859,8712,1798,2136,13371,26017
3,84976,45956,8797,611669,22407,1814,2070,14547,40838
3,86281,45129,8723,546133,6489,1834,2032,16499,26854
4,86881,35999,7087,442368,6408,1920,2046,11003,21377
4,85747,51242,7285,466944,6045,1729,2134,10395,20303
4,87967,51385,6705,466944,10330,1820,2158,11146,25454
4,92069,51382,5828,466944,5273,1767,2480,11044,20564
4,93569,51975,6180,491520,4556,1978,2160,10556,19250
4,95582,52916,6194,475136,6443,1769,2152,12111,22475
5,94837,44384,5900,511180,6043,1941,2145,13932,24061
5,93343,44598,6169,419430,9705,1756,2135,12778,26374
5,91749,44875,6234,511180,9269,1754,2188,15257,28468
4,91001,56519,7581,524288,11140,1867,2178,12765,27950
3,91830,51185,7998,611669,5580,1758,2220,9611,19169
3,90633,51168,7884,524288,7692,1801,2017,14035,25545
3,73802,45486,6233,349525,4951,1941,2328,9875,19095
4,88114,56090,7611,655360,3503,1763,2355,14116,21737
1,90363,90363,11604,1048576,10869,1817,2044,7141,21871
1,92095,92095,11418,1048576,3163,1749,2042,7441,14395
1,93083,93083,12344,1048576,3820,1750,2037,5911,13518
3,81799,45272,5964,524288,4173,1736,2184,8394,16487
3,83990,45009,6063,349525,4492,2312,2188,6719,15711
3,95623,48319,7624,524288,2987,1716,2107,8246,15056
4,93707,57148,7111,524288,7014,1793,2143,11407,22357
4,94941,57234,6936,655360,6057,1838,2256,14052,24203
4,96647,57505,6600,655360,6565,1807,2147,12736,23255
4,97829,57367,6509,622592,6791,1896,2219,14599,25505
4,99467,57294,6787,491520,6978,1796,2240,11080,22094
4,101626,57664,6431,491520,9715,1766,2251,14493,28225
4,103902,58017,6203,458752,8302,2563,2330,10453,23648
4,105785,58200,6267,458752,7199,2821,2274,11249,23543
4,110541,58394,5787,491520,5736,3082,2366,11068,22252
4,112424,58515,5749,475136,5390,1925,2235,10982,20532
4,112612,58126,5679,475136,4945,1817,2289,10481,19532
4,112539,57992,5590,475136,4828,1788,2178,10670,19464
4,111930,57822,5966,475136,6236,1793,2209,10594,20832
5,111542,46045,4732,406323,7731,1745,2176,11555,23207
4,110137,57091,6064,475136,9338,1791,2204,11474,24807
3,90933,39639,4268,283989,6049,2079,2241,5936,16305
4,109755,57225,6292,475136,3424,1795,2172,10258,17649
4,109358,56999,6796,475136,5478,1859,2149,10594,20080
4,109918,57204,6337,475136,4840,1819,2241,10530,19430
4,109862,57160,6245,475136,8827,1795,2227,15070,27919
4,109907,57208,6190,475136,5244,1753,2175,11973,21145
4,111027,57388,6091,475136,7462,1794,2208,12050,23514
5,111500,46187,5005,381747,7885,1823,2295,11607,23610
5,111207,46212,5306,381747,16957,1793,2588,12175,33513
5,114428,29813,4319,285081,6085,1881,2180,8752,18898
5,114001,30019,4385,285081,4575,1798,2324,9246,17943
4,113953,37332,5257,352256,3860,1754,2572,8253,16439
5,114063,30809,4430,291635,3901,1708,2251,8931,16791
5,113073,30991,4485,294912,4460,1813,2034,8625,16932
5,112332,31394,4229,190054,7056,1749,2046,6974,17825
5,111115,31450,4459,190054,4684,1772,2080,9472,18008
5,108854,31974,4365,203161,3292,1711,2039,7616,14658
5,107394,32331,4230,255590,3856,1772,2090,8403,16121
4,106062,32345,4075,196608,5722,1821,2150,5879,15572
3,104572,51413,6180,393216,2838,1981,2086,7110,14015
3,103690,51844,6201,393216,3594,2169,2191,7180,15134
6,101674,27657,3599,240298,5535,1753,2102,11718,21108
6,100648,28936,4020,240298,8223,1864,2146,9444,21677
6,99205,28016,3859,262144,8220,1767,2121,11652,23760
4,94516,50272,6063,393216,5524,1763,2826,9326,19439
6,96042,28204,3770,243029,4914,1783,2245,9561,18503
7,92099,32114,4429,280868,4872,2228,2389,11489,20978
7,90819,32158,4258,280868,5211,1832,2275,11803,21121
6,92896,32093,4455,283989,5630,2029,2202,10119,19980
6,92369,32429,4508,294912,5497,1822,2160,10967,20446
6,91676,32434,4432,278528,5251,1766,2154,10799,19970
6,90077,32593,4739,278528,4720,1710,2428,9748,18606
5,89227,39246,5746,275251,4684,1788,2148,8794,17414
5,88268,39538,6133,321126,4636,1747,2764,9746,18893
6,85820,35644,6298,354986,8798,1787,2175,14736,27496
5,82112,42794,6599,419430,6416,2076,2194,12437,23123
5,78027,43382,6117,419430,4697,2126,2264,11611,20698
5,77978,43640,5127,419430,11824,2176,2225,13374,29599
5,96752,44016,4357,262144,8255,1819,2181,8201,20456
5,107450,44331,4030,340787,4645,1790,2401,9547,18383
5,118312,44366,4087,196608,5408,1789,2317,7105,16619
4,127391,53900,3778,229376,3027,1702,2163,5835,12727
5,135762,45324,3925,288358,2900,1782,2168,8863,15713
4,143370,54714,3809,229376,4133,1733,2400,7032,15298
1,149955,149955,7187,524288,3872,2007,2290,3361,11530
1,155895,155895,7086,524288,2744,1760,2256,3608,10368
1,159342,159342,7212,524288,2589,1812,2311,4957,11669
1,163384,163384,6740,524288,1825,1741,2194,3367,9127
1,166147,166147,6776,524288,1857,1728,2194,3615,9394
1,168252,168252,6368,524288,1898,1708,2215,3419,9240
1,169120,169120,7029,524288,2794,3889,2277,3450,12410
1,169866,169866,6746,524288,2751,2031,2234,3511,10527
1,169828,169828,6364,524288,1871,1743,2201,5701,11516
1,169415,169415,6548,524288,2617,1728,2256,3469,10070
1,168592,168592,7035,524288,3228,1744,2210,3507,10689
1,168327,168327,6883,524288,2208,1852,2240,3358,9658
1,167868,167868,6868,524288,1884,1793,2222,3404,9303
1,166945,166945,7139,524288,3080,1727,2238,4294,11339
5,165558,39243,5326,368640,2144,1728,2263,14678,20813
1,166652,166652,6838,524288,5749,1775,2234,3673,13431
5,164925,37825,4344,288358,2806,1833,2250,9626,16515
3,162257,60362,5981,305834,4776,1813,2265,6826,15680
3,160181,60178,5984,305834,3696,1807,2200,5809,13512
4,158448,48375,5348,245760,3907,1908,2481,6688,14984
3,157638,59896,5839,305834,3963,2148,3360,6030,15501
5,155649,38671,5043,288358,2820,1728,2171,10438,17157
5,153539,38555,4871,314572,6379,1815,2215,12967,23376
5,150797,37659,4602,289996,6478,2547,2328,10884,22237
7,150048,28968,4141,257462,8925,1831,3770,11632,26158
1,148589,148589,5993,524288,6516,1846,2234,4278,14874
4,149113,48231,5440,311296,2084,1791,2205,7632,13712
4,150180,48797,6032,344064,6227,1837,2228,9204,19496
4,151822,49147,6056,311296,4435,1706,2230,7669,16040
4,153073,49275,5884,278528,4865,1823,2308,7191,16187
3,153883,65385,7431,371370,3676,1733,2450,6379,14238
6,153024,34867,6366,327680,3356,1711,2229,12951,20247
4,149507,51012,7720,344064,9343,1758,2144,9586,22831
5,145565,40250,7745,399769,4693,1731,2347,11967,20738
5,141017,40749,7966,294912,7225,1824,2188,12505,23742
4,135199,50009,7540,360448,5014,1721,2200,9422,18357
5,128760,39873,6341,239206,7141,1755,2160,8836,19892
3,121888,60150,6124,305834,5113,1844,2424,7267,16648
5,116514,38569,6777,275251,3635,1788,2134,8942,16499
3,112288,58452,8741,524288,5379,1725,2070,10274,19448
4,108277,46786,9317,655360,5080,1803,2353,16337,25573
5,105174,38052,7898,681574,7325,1763,2380,16910,28378
5,102573,37575,7095,380108,10613,1953,2113,11211,25890
5,99588,37486,7453,434176,8810,1785,2126,12021,24742
4,95420,46282,8967,720896,6246,1789,2180,14880,25095
4,94614,46096,9720,786432,8692,2149,2211,15539,28591
4,93136,45857,8682,589824,9667,1994,2127,13902,27690
3,90789,58288,8608,873813,9675,2140,2114,12658,26587
4,84314,44700,7496,475136,6746,2002,2100,11597,22445
4,84510,43573,6787,655360,7372,1939,2093,13920,25324
1,78156,78156,5420,1048576,9085,2264,2355,11264,24968
5,92870,36714,10358,491520,3539,1986,2104,15389,23018
5,94054,36464,11142,491520,10093,1964,2116,16562,30735
3,100644,57077,9274,546133,6990,2247,2103,10185,21525
5,100482,37053,7465,439091,4582,2035,2113,12089,20819
4,110390,47463,8111,409600,6548,1882,2077,9645,20152
4,113854,47904,8187,344064,5621,2010,2140,8268,18039
4,117640,48284,8142,344064,3884,1763,2089,8006,15742
4,119705,47999,7900,409600,5128,1992,2097,9122,18339
4,120960,47681,7933,245760,4484,1923,2314,6927,15648
4,121182,47196,8505,344064,3477,1779,2094,7941,15291
4,123934,46274,8458,245760,5208,2047,2080,8784,18119
3,125045,60182,10194,283989,4890,2066,2086,6011,15053
3,125514,59884,10678,283989,5478,2057,2077,6044,15656
4,127290,45623,8444,245760,3506,2030,2091,7845,15472
3,126873,58551,10121,283989,6892,2107,2076,6219,17294
1,128215,128215,26321,524288,3275,2015,2032,7586,14908
5,128559,35155,6647,196608,1928,1828,2037,8557,14350
5,127861,34718,6478,199884,4049,2194,2094,7799,16136
3,126464,44008,9356,360448,4150,1990,2012,6641,14793
3,124591,43493,8660,354986,3561,1990,2105,6920,14576
3,122879,42776,8941,393216,6179,2084,2037,7441,17741
1,121428,121428,23443,524288,6615,2320,2097,3926,14958
4,119656,31657,6539,671744,3355,1900,2008,14656,21919
3,118300,44054,9027,283989,7377,1957,2118,5873,17325
6,112955,25175,5868,415061,3729,1789,2066,14211,21795
2,108105,56452,22799,786432,6358,2014,2034,8821,19227
7,94197,17468,9589,599186,5602,2072,2158,22270,32102
3,93651,35230,16389,546133,15539,2041,2592,10044,30216
4,84210,28066,11511,364544,5280,2110,2232,9876,19498
3,79596,38356,15647,567978,4728,2040,2034,11028,19830
5,74826,24802,9975,550502,5259,2037,2055,15926,25277
4,69110,29805,11487,475136,8150,2093,2360,10915,23518
4,70972,32638,12327,524288,9865,2801,2595,11574,26835
7,66348,20848,8057,356937,6416,2039,2103,15112,25670
7,64939,21389,7821,328850,10020,2130,2129,14398,28677
6,62043,24307,9091,382293,8199,2126,2134,13029,25488
2,65680,62023,19657,786432,6972,2291,2108,8386,19757
5,68832,28073,9929,432537,4314,1996,2034,11331,19675
9,67858,15530,6462,564337,6914,1949,2217,26544,37624
7,70805,19632,7076,290230,15521,2097,2107,16622,36347
4,69749,28316,9437,311296,7972,2057,2191,11764,23984
9,66993,14227,5201,342243,3684,1921,2132,23042,30779
5,64559,20861,5652,324403,8684,2200,2144,8994,22022
8,65633,13079,3990,311296,7983,2076,2160,14546,26765
5,64268,19356,5236,275251,9622,1816,2176,9830,23444
9,63415,12226,4496,283989,3726,1914,2166,14363,22169
2,64376,41222,8855,524288,7068,1868,2108,5634,16678
3,63222,28788,7692,349525,2850,1789,2014,5854,12507
2,64332,39790,9956,393216,3937,1728,2112,5178,12955
5,65075,19379,6805,321126,3650,1848,2057,9231,16786
5,65556,19347,7431,321126,4283,1810,2039,9624,17756
9,66267,12261,5512,251221,5798,1928,2163,14462,24351
9,67169,12553,5162,375011,7417,1788,2137,18911,30253
8,66983,12597,3987,305152,11617,1786,2424,14429,30256
9,68647,11912,4712,299463,13089,1943,2465,19575,37072
14,70127,9424,4586,378002,8477,1806,2647,29857,42787
11,72438,11199,4826,318743,15626,1945,2200,21672,41443
9,75954,14430,6235,553415,9849,1862,2129,25052,38892
5,77087,22451,5841,209715,16106,1863,2065,7188,27222
10,76190,13020,4751,181862,4178,1845,2447,11823,20293
5,76130,22884,7393,235929,6344,1835,2188,8751,19118
7,75367,19275,6727,243419,3881,1752,2136,10250,18019
7,75120,19055,6170,313636,7107,1838,2175,12974,24094
9,76158,15566,5639,258503,6622,1790,2149,15297,25858
5,76125,23918,7563,471859,7942,1730,2107,12512,24291
7,76313,18998,6637,280868,7628,2706,2129,18425,30888
5,75457,23206,7250,393216,8763,1831,2107,11232,23933
8,72628,14359,5547,477184,6288,1878,2132,21597,31895
9,68996,12305,5249,466033,15094,1822,2391,20904,40211
8,62561,11853,5233,409600,11737,1778,2298,17361,33174
1,59673,59673,10439,1048576,8009,1793,2419,5352,17573
10,55702,10296,5064,478412,3045,1734,2104,23483,30366
6,50598,13581,5047,273066,13396,5081,2119,12996,33592
5,46381,14843,5417,281804,5283,1756,1980,8968,17987
7,42128,10144,4375,170861,4331,1756,2026,8189,16302
5,33558,12940,5526,288358,4309,1749,2289,8609,16956
4,26464,13253,4932,147456,5760,2199,2052,4805,14816
3,20717,13488,3744,109226,2640,1859,4145,4562,13206
3,15264,12132,3654,87381,2458,1840,1920,3024,9242
3,16823,11375,3943,152917,2018,1736,1939,4509,10202
4,14939,9790,4474,163840,3338,1751,2097,5190,12376
3,28598,11535,2549,458752,3190,1775,1972,7271,14208
3,28390,13084,4986,283989,3888,1765,1916,4956,12525
1,25718,25718,7221,262144,5811,1777,1887,1837,11312
2,28245,18766,10788,393216,1495,1761,1969,4175,9400
3,28846,20182,8947,436906,2536,1720,1958,6693,12907
3,32015,20325,6646,436906,3553,1742,1962,7524,14781
4,30916,16383,7569,589824,4573,1944,2223,11295,20035
3,28558,19886,4733,611669,7186,1866,2103,8590,19745
3,24969,18349,9650,524288,5361,2002,2024,9167,18554
6,19211,10477,4863,374101,5428,1991,2072,12325,21816
3,18393,17172,7903,349525,8684,1749,1904,7361,19698
4,18360,13836,6218,409600,2950,1743,1970,9840,16503
3,14135,10485,5348,371370,7514,1768,2191,7617,19090
3,10292,6253,3377,218453,5141,1796,2045,4808,13790
3,10907,9329,12240,371370,7049,1800,1907,7072,17828
2,12738,11907,12342,786432,3566,1833,1988,8619,16006
6,15627,7974,4360,256682,5883,1871,1980,12056,21790
6,19058,10489,8165,546133,4168,1827,2104,16757,24856
8,19052,7181,6304,542720,8673,1804,2044,25511,38032
5,16895,11639,8331,471859,11954,1848,1991,13445,29238
8,16951,8339,6920,557056,9805,1832,2063,24790,38490
7,14852,8888,5608,318610,12499,1900,2116,14018,30533
